msg_seq,t_tx_ns,t_rx_ns,lat_ms,payload_app,payload_envelope,wire_up_l3_bytes,wire_down_l3_bytes,wire_l3_bytes,frames_up,frames_down,msg_total_bytes_enviada,eficiencia_env,overhead_env_bytes
1,1758581955995596351,1758581956133774211,138.178,461,485,1894,838,2732,33,33,1894,0.25607180570221755,1409
2,1758582556221230470,1758582556403410040,182.18,461,485,1894,838,2732,33,33,1894,0.25607180570221755,1409
3,1758583156420621766,1758583156676492098,255.87,461,485,1894,838,2732,33,33,1894,0.25607180570221755,1409
4,1758583756612037871,1758583756639761825,27.724,461,485,1894,838,2732,33,33,1894,0.25607180570221755,1409
5,1758584355798140983,1758584355989069065,190.928,461,485,1894,838,2732,33,33,1894,0.25607180570221755,1409
6,1758584955988682110,1758584956260449536,271.767,461,485,1894,838,2732,33,33,1894,0.25607180570221755,1409
7,1758585556206037430,1758585556362721982,156.685,461,485,1894,838,2732,33,33,1894,0.25607180570221755,1409
8,1758586156418789829,1758586156638331655,219.542,461,485,1894,838,2732,33,33,1894,0.25607180570221755,1409
9,1758586756624338887,1758586756909976389,285.638,461,485,1894,838,2732,33,33,1894,0.25607180570221755,1409
10,1758587355827451260,1758587355943123359,115.672,462,486,1971,902,2873,35,35,1971,0.2465753424657534,1485
11,1758587956044531627,1758587956077903660,33.372,462,486,1895,838,2733,33,33,1895,0.25646437994722954,1409
12,1758588556248363145,1758588556538570966,290.208,462,486,2123,1030,3153,39,39,2123,0.2289213377296279,1637
13,1758589156459530601,1758589156623018047,163.487,462,486,1959,914,2873,35,35,1959,0.24808575803981622,1473
14,1758589755670166245,1758589757030448980,1360.283,462,486,2686,1094,3780,41,41,2686,0.18093819806403574,2200
15,1758590355878411126,1758590356204814606,326.403,458,482,1891,838,2729,33,33,1891,0.2548915917503966,1409
16,1758590956101044701,1758590956179342425,78.298,458,482,2195,1094,3289,41,41,2195,0.21958997722095672,1713
17,1758591556319529729,1758591556376923083,57.393,458,482,2043,966,3009,37,37,2043,0.2359275575134606,1561
18,1758592156521407301,1758592156528007035,6.6,458,482,2067,1070,3137,39,39,2067,0.2331881954523464,1585
19,1758592757710015813,1758592757776342242,66.326,458,482,1967,902,2869,35,35,1967,0.24504321301474327,1485
20,1758593355916400643,1758593356010039666,93.639,458,482,2195,1146,3341,42,42,2195,0.21958997722095672,1713
21,1758593956135915090,1758593957752638209,1616.723,458,482,2602,1082,3684,40,40,2602,0.18524212144504226,2120
22,1758594556350175688,1758594556442251812,92.076,458,482,2119,1030,3149,39,39,2119,0.22746578574799434,1637
23,1758595157561587542,1758595159319920885,1758.333,458,482,2754,1158,3912,43,43,2754,0.17501815541031226,2272
24,1758595755750319457,1758595757391716619,1641.397,458,482,2602,1030,3632,39,39,2602,0.18524212144504226,2120
25,1758596355961459874,1758596356033174657,71.715,458,482,2195,1146,3341,42,42,2195,0.21958997722095672,1713
26,1758596956183929915,1758596956205384367,21.454,458,482,2043,966,3009,37,37,2043,0.2359275575134606,1561
27,1758597561383533316,1758597561418769989,35.237,458,482,1967,902,2869,35,35,1967,0.24504321301474327,1485
28,1758598156578456188,1758598156911205308,332.749,458,482,2043,966,3009,37,37,2043,0.2359275575134606,1561
29,1758598758773248571,1758598759069655018,296.406,458,482,2195,1094,3289,41,41,2195,0.21958997722095672,1713
30,1758599355968228553,1758599356171438497,203.21,458,482,2259,1222,3481,44,44,2259,0.21336874723328905,1777
31,1758599956163782081,1758599956295674714,131.893,458,482,2043,966,3009,37,37,2043,0.2359275575134606,1561
32,1758600556349495906,1758600556514607888,165.112,458,482,2195,1094,3289,41,41,2195,0.21958997722095672,1713
33,1758601156560164690,1758601156573161501,12.997,458,482,2043,1018,3061,38,38,2043,0.2359275575134606,1561
34,1758601755767887422,1758601755882495478,114.608,458,482,2067,1018,3085,38,38,2067,0.2331881954523464,1585
35,1758602356980007976,1758602358044285232,1064.277,458,482,2195,1094,3289,41,41,2195,0.21958997722095672,1713
36,1758602956192968799,1758602956483133953,290.165,458,482,2043,966,3009,37,37,2043,0.2359275575134606,1561
37,1758603556398617134,1758603559338045379,2939.428,458,482,2830,1222,4052,45,45,2830,0.17031802120141343,2348
38,1758604156583665978,1758604156811512537,227.847,458,482,2271,1158,3429,43,43,2271,0.21224130339057684,1789
39,1758604757787462673,1758604759728110426,1940.648,458,482,2754,1262,4016,45,45,2754,0.17501815541031226,2272
40,1758605355991375620,1758605356173310883,181.935,458,482,2183,1158,3341,42,42,2183,0.22079706825469536,1701
41,1758605956204317229,1758605956299614975,95.298,458,482,2195,1146,3341,42,42,2195,0.21958997722095672,1713
42,1758606556414678172,1758606556569879960,155.202,458,482,2043,966,3009,37,37,2043,0.2359275575134606,1561
43,1758607157607251139,1758607157917024516,309.773,458,482,2119,1030,3149,39,39,2119,0.22746578574799434,1637
44,1758607755809245541,1758607755895597122,86.352,458,482,2031,978,3009,37,37,2031,0.23732151649433778,1549
45,1758608356021554928,1758608356280563632,259.009,458,482,2271,1210,3481,44,44,2271,0.21224130339057684,1789
46,1758608956236866753,1758608956351331017,114.464,458,482,2183,1106,3289,41,41,2183,0.22079706825469536,1701
47,1758609556438743161,1758609556686465607,247.722,458,482,1967,902,2869,35,35,1967,0.24504321301474327,1485
48,1758610156624162018,1758610156670812263,46.65,458,482,2119,1082,3201,40,40,2119,0.22746578574799434,1637
49,1758610755827833692,1758610755912112001,84.278,458,482,2107,1042,3149,39,39,2107,0.22876127195064072,1625
50,1758611356045461912,1758611356059462021,14.0,458,482,1991,954,2945,36,36,1991,0.24208940231039677,1509
51,1758611956260993316,1758611956552013545,291.02,458,482,2271,1158,3429,43,43,2271,0.21224130339057684,1789
52,1758612556450197910,1758612556596379028,146.181,458,482,2043,1018,3061,38,38,2043,0.2359275575134606,1561
53,1758613157649863685,1758613157929257938,279.394,458,482,2119,1030,3149,39,39,2119,0.22746578574799434,1637
54,1758613755839847636,1758613755908117142,68.27,458,482,2423,1286,3709,47,47,2423,0.19892695006190672,1941
55,1758614356045404546,1758614356081360220,35.956,458,482,1967,902,2869,35,35,1967,0.24504321301474327,1485
56,1758614957256230297,1758614957314941754,58.711,458,482,2031,978,3009,37,37,2031,0.23732151649433778,1549
57,1758615556465752758,1758615556489913048,24.16,458,482,2423,1222,3645,46,46,2423,0.19892695006190672,1941
58,1758616156666201340,1758616156855349981,189.149,458,482,2043,966,3009,37,37,2043,0.2359275575134606,1561
59,1758616758863821723,1758616758895814243,31.993,458,482,1967,902,2869,35,35,1967,0.24504321301474327,1485
60,1758617357066837120,1758617357279361191,212.524,458,482,2119,1082,3201,40,40,2119,0.22746578574799434,1637
61,1758617956282970923,1758617956328583260,45.612,458,482,2043,966,3009,37,37,2043,0.2359275575134606,1561
62,1758618556495215964,1758618556539046916,43.831,458,482,2195,1094,3289,41,41,2195,0.21958997722095672,1713
63,1758619156697879520,1758619156946428262,248.549,458,482,1967,902,2869,35,35,1967,0.24504321301474327,1485
64,1758619755901974055,1758619756012970515,110.996,458,482,2043,966,3009,37,37,2043,0.2359275575134606,1561
65,1758620358118564396,1758620358132777924,14.214,458,482,1967,902,2869,35,35,1967,0.24504321301474327,1485
66,1758620956326653049,1758620956340719561,14.067,458,482,1967,902,2869,35,35,1967,0.24504321301474327,1485
67,1758621558515330856,1758621558528203182,12.872,458,482,2195,1094,3289,41,41,2195,0.21958997722095672,1713
68,1758622156726412998,1758622156740525269,14.112,458,482,1839,826,2665,32,32,1839,0.26209896682979883,1357
69,1758622755934076246,1758622756029071760,94.996,458,482,2043,966,3009,37,37,2043,0.2359275575134606,1561
70,1758623356154550099,1758623356220674481,66.124,462,486,1971,902,2873,35,35,1971,0.2465753424657534,1485
71,1758623956350600716,1758623956515136120,164.535,458,482,2043,1018,3061,38,38,2043,0.2359275575134606,1561
72,1758624556557467372,1758624556807485892,250.019,458,482,2119,1082,3201,40,40,2119,0.22746578574799434,1637
73,1758625155757188299,1758625155821802269,64.614,458,482,2043,1018,3061,38,38,2043,0.2359275575134606,1561
74,1758625757964289630,1758625759711434274,1747.145,458,482,2526,966,3492,37,37,2526,0.19081551860649248,2044
75,1758626356184469526,1758626356327485949,143.016,458,482,1891,838,2729,33,33,1891,0.2548915917503966,1409
76,1758626956384449083,1758626956516026140,131.577,458,482,1891,838,2729,33,33,1891,0.2548915917503966,1409
77,1758627556577651997,1758627556892086397,314.434,458,482,2195,1094,3289,41,41,2195,0.21958997722095672,1713
78,1758628155758168993,1758628155921446043,163.277,458,482,2043,966,3009,37,37,2043,0.2359275575134606,1561
79,1758628755969959920,1758628756089717418,119.757,458,482,1891,838,2729,33,33,1891,0.2548915917503966,1409
80,1758629356190357125,1758629356337169997,146.813,458,482,2195,1146,3341,42,42,2195,0.21958997722095672,1713
81,1758629956401419005,1758629956482527228,81.108,458,482,2043,1070,3113,39,39,2043,0.2359275575134606,1561
82,1758630555607453004,1758630555853962921,246.51,462,486,1895,838,2733,33,33,1895,0.25646437994722954,1409
83,1758631155811941296,1758631155900586864,88.646,462,486,1895,838,2733,33,33,1895,0.25646437994722954,1409
84,1758631756026864837,1758631756338356838,311.492,462,486,1895,838,2733,33,33,1895,0.25646437994722954,1409
85,1758632356246014589,1758632356386379459,140.365,462,486,2199,1146,3345,42,42,2199,0.22100954979536153,1713
86,1758632956456226709,1758632956502811914,46.585,462,486,2047,966,3013,37,37,2047,0.23742061553492916,1561
87,1758633555647994036,1758633555885862923,237.869,462,486,2047,966,3013,37,37,2047,0.23742061553492916,1561
88,1758634156853868727,1758634156867004838,13.136,462,486,1843,826,2669,32,32,1843,0.26370048833423765,1357
89,1758634756070441952,1758634756113584829,43.143,462,486,2047,966,3013,37,37,2047,0.23742061553492916,1561
90,1758635356283458307,1758635356412638872,129.181,462,486,1895,838,2733,33,33,1895,0.25646437994722954,1409
91,1758635956477480664,1758635956500420455,22.94,462,486,2047,1018,3065,38,38,2047,0.23742061553492916,1561
92,1758636555686363845,1758636555907013695,220.65,462,486,1895,838,2733,33,33,1895,0.25646437994722954,1409
93,1758637155894107586,1758637156177448673,283.341,462,486,1895,838,2733,33,33,1895,0.25646437994722954,1409
94,1758637756117952994,1758637756217652119,99.699,462,486,1895,838,2733,33,33,1895,0.25646437994722954,1409
95,1758638356329515955,1758638356390931239,61.415,462,486,1971,954,2925,36,36,1971,0.2465753424657534,1485
96,1758638956521200499,1758638956586544704,65.344,462,486,1895,838,2733,33,33,1895,0.25646437994722954,1409
97,1758639555707351856,1758639555832998161,125.646,462,486,2047,966,3013,37,37,2047,0.23742061553492916,1561
98,1758640155910252245,1758640156149199477,238.947,462,486,2263,1222,3485,44,44,2263,0.2147591692443659,1777
99,1758640756131090982,1758640756341648506,210.558,462,486,1895,838,2733,33,33,1895,0.25646437994722954,1409
100,1758641357347846988,1758641357658228200,310.381,463,487,2188,1106,3294,41,41,2188,0.22257769652650822,1701
101,1758641957543771187,1758641957852925657,309.154,467,491,1964,914,2878,35,35,1964,0.25,1473
102,1758642556724453774,1758642556771504261,47.05,467,491,2052,1018,3070,38,38,2052,0.23927875243664717,1561
103,1758643155933201077,1758643155984121877,50.921,467,491,1900,838,2738,33,33,1900,0.25842105263157894,1409
104,1758643756154951555,1758643756288098415,133.147,463,487,1896,838,2734,33,33,1896,0.2568565400843882,1409
105,1758644356374320072,1758644356560568310,186.248,467,491,1900,838,2738,33,33,1900,0.25842105263157894,1409
106,1758644956584328043,1758644956880454691,296.127,463,487,1896,838,2734,33,33,1896,0.2568565400843882,1409
107,1758645555790041407,1758645556050921029,260.88,467,491,1900,838,2738,33,33,1900,0.25842105263157894,1409
108,1758646156006807126,1758646156071097763,64.291,467,491,1900,838,2738,33,33,1900,0.25842105263157894,1409
109,1758646756224843453,1758646756316115432,91.272,463,487,1896,838,2734,33,33,1896,0.2568565400843882,1409
110,1758647356433128450,1758647356446300832,13.172,463,487,1896,838,2734,33,33,1896,0.2568565400843882,1409
111,1758647956628722791,1758647956922806306,294.084,467,491,1900,838,2738,33,33,1900,0.25842105263157894,1409
112,1758648556820542755,1758648556841088757,20.546,467,491,1772,762,2534,30,30,1772,0.2770880361173815,1281
113,1758649156037377806,1758649156356906575,319.529,467,491,1900,838,2738,33,33,1900,0.25842105263157894,1409
114,1758649756254939556,1758649756332494123,77.555,467,491,1900,838,2738,33,33,1900,0.25842105263157894,1409
115,1758650356465645858,1758650356592938402,127.293,467,491,1900,838,2738,33,33,1900,0.25842105263157894,1409
116,1758650955673835171,1758650955943928588,270.093,467,491,1900,838,2738,33,33,1900,0.25842105263157894,1409
117,1758651555881039638,1758651555910407043,29.367,467,491,1976,902,2878,35,35,1976,0.24848178137651822,1485
118,1758652156101091693,1758652156409550398,308.459,467,491,1900,838,2738,33,33,1900,0.25842105263157894,1409
119,1758652756299138210,1758652756475446725,176.309,467,491,1900,838,2738,33,33,1900,0.25842105263157894,1409
120,1758653356482307637,1758653356610288784,127.981,467,491,1900,838,2738,33,33,1900,0.25842105263157894,1409
121,1758653955687169474,1758653955936017322,248.848,467,491,1900,838,2738,33,33,1900,0.25842105263157894,1409
122,1758654555896569815,1758654556053096375,156.527,463,487,1896,838,2734,33,33,1896,0.2568565400843882,1409
123,1758655156116926666,1758655156328024650,211.098,467,491,1900,838,2738,33,33,1900,0.25842105263157894,1409
124,1758655756325131390,1758655756591171063,266.04,467,491,1900,838,2738,33,33,1900,0.25842105263157894,1409
125,1758656356522297412,1758656356562697980,40.401,463,487,1896,838,2734,33,33,1896,0.2568565400843882,1409
126,1758656956712247472,1758656956938361069,226.114,467,491,1900,838,2738,33,33,1900,0.25842105263157894,1409
127,1758657555919558936,1758657555983585895,64.027,467,491,4737,3410,8147,79,79,4737,0.10365210048553937,4246
128,1758658756353650309,1758658756350852664,0.0,463,487,1332,760,2092,31,31,1332,0.3656156156156156,845
129,1758659356562383881,1758659356620489311,58.105,467,491,2468,916,3384,35,35,2468,0.19894651539708266,1977
130,1758659956772035772,1758659956772028701,0.0,467,491,1204,684,1888,28,28,1204,0.40780730897009965,713
131,1758660555983438881,1758660556238688332,255.249,467,491,1900,838,2738,33,33,1900,0.25842105263157894,1409
132,1758661156200470636,1758661156427544881,227.074,467,491,2052,1018,3070,38,38,2052,0.23927875243664717,1561
133,1758661756399999062,1758661756603709134,203.71,463,487,1896,838,2734,33,33,1896,0.2568565400843882,1409
134,1758662356583883479,1758662356874027424,290.144,467,491,1976,902,2878,35,35,1976,0.24848178137651822,1485
135,1758662955790773733,1758662955963688659,172.915,467,491,1900,838,2738,33,33,1900,0.25842105263157894,1409
136,1758663556004944989,1758663556248402709,243.458,463,487,1896,838,2734,33,33,1896,0.2568565400843882,1409
137,1758664156221477148,1758664156464600119,243.123,463,487,1896,838,2734,33,33,1896,0.2568565400843882,1409
138,1758664756419239714,1758664756740152025,320.912,467,491,1900,838,2738,33,33,1900,0.25842105263157894,1409
139,1758665356608764807,1758665356707989426,99.225,463,487,1896,838,2734,33,33,1896,0.2568565400843882,1409
140,1758665956791853816,1758665956976952893,185.099,467,491,1900,838,2738,33,33,1900,0.25842105263157894,1409
141,1758666556005392149,1758666556326656220,321.264,467,491,1900,838,2738,33,33,1900,0.25842105263157894,1409
142,1758667156217202177,1758667156297650313,80.448,467,491,1976,902,2878,35,35,1976,0.24848178137651822,1485
143,1758667756432473870,1758667756560397777,127.924,463,487,1896,838,2734,33,33,1896,0.2568565400843882,1409
144,1758668356643169179,1758668356831969389,188.8,467,491,1976,902,2878,35,35,1976,0.24848178137651822,1485
145,1758668955849567271,1758668955873469869,23.903,467,491,1900,838,2738,33,33,1900,0.25842105263157894,1409
146,1758669556068455892,1758669556145632603,77.177,467,491,1900,838,2738,33,33,1900,0.25842105263157894,1409
147,1758670156286032160,1758670156414021051,127.989,463,487,1896,838,2734,33,33,1896,0.2568565400843882,1409
148,1758670756491861541,1758670756687508897,195.647,467,491,1900,838,2738,33,33,1900,0.25842105263157894,1409
149,1758671356691418673,1758671356894949918,203.531,467,491,1900,838,2738,33,33,1900,0.25842105263157894,1409
150,1758671955885919400,1758671955939412410,53.493,467,491,1900,838,2738,33,33,1900,0.25842105263157894,1409
151,1758672556098546808,1758672556304109439,205.563,467,491,1900,838,2738,33,33,1900,0.25842105263157894,1409
152,1758673156295438031,1758673156574882598,279.445,463,487,1896,838,2734,33,33,1896,0.2568565400843882,1409
153,1758673756503903026,1758673756513829543,9.927,467,491,1900,838,2738,33,33,1900,0.25842105263157894,1409
154,1758674355715317516,1758674355888632792,173.315,467,491,1900,838,2738,33,33,1900,0.25842105263157894,1409
155,1758674955919130181,1758674955929444828,10.315,467,491,1772,762,2534,30,30,1772,0.2770880361173815,1281
156,1758675556138472060,1758675556207066144,68.594,467,491,1900,838,2738,33,33,1900,0.25842105263157894,1409
157,1758676156349730555,1758676156481068981,131.338,467,491,1900,838,2738,33,33,1900,0.25842105263157894,1409
158,1758676755550257903,1758676755831521380,281.263,467,491,1900,838,2738,33,33,1900,0.25842105263157894,1409
159,1758677356745447176,1758677357021322702,275.876,463,487,1896,838,2734,33,33,1896,0.2568565400843882,1409
160,1758677955936647897,1758677956066257918,129.61,467,491,1900,838,2738,33,33,1900,0.25842105263157894,1409
161,1758678556137724921,1758678556387139328,249.414,467,491,1900,838,2738,33,33,1900,0.25842105263157894,1409
162,1758679156345932188,1758679156420637081,74.705,463,487,1896,838,2734,33,33,1896,0.2568565400843882,1409
163,1758679756556317346,1758679756882983352,326.666,463,487,1896,838,2734,33,33,1896,0.2568565400843882,1409
164,1758680356753072700,1758680356987658487,234.586,463,487,1896,838,2734,33,33,1896,0.2568565400843882,1409
165,1758680955952619046,1758680956228889216,276.27,463,487,1896,838,2734,33,33,1896,0.2568565400843882,1409
166,1758681556162708889,1758681556280037335,117.328,463,487,1896,838,2734,33,33,1896,0.2568565400843882,1409
167,1758682156353271216,1758682156528080765,174.81,463,487,2048,1018,3066,38,38,2048,0.23779296875,1561
168,1758682756556699121,1758682756580567709,23.869,463,487,2200,1146,3346,42,42,2200,0.22136363636363637,1713
169,1758683356765918170,1758683356878616402,112.698,463,487,1896,838,2734,33,33,1896,0.2568565400843882,1409
170,1758683959970713299,1758683960203901432,233.188,463,487,1972,902,2874,35,35,1972,0.24695740365111563,1485
171,1758684556185351416,1758684556401887465,216.536,459,483,1892,838,2730,33,33,1892,0.25528541226215645,1409
172,1758685156382075446,1758685156560137103,178.062,459,483,2272,1210,3482,44,44,2272,0.2125880281690141,1789
173,1758685756567236494,1758685756677839443,110.603,463,487,1972,902,2874,35,35,1972,0.24695740365111563,1485
174,1758686358754260808,1758686358793548276,39.287,463,487,1896,838,2734,33,33,1896,0.2568565400843882,1409
175,1758686955961385958,1758686955975091242,13.705,463,487,2200,1094,3294,41,41,2200,0.22136363636363637,1713
176,1758687556174306667,1758687556188035732,13.729,463,487,1844,826,2670,32,32,1844,0.26409978308026033,1357
177,1758688157381635647,1758688157969187208,587.552,463,487,2048,1018,3066,38,38,2048,0.23779296875,1561
178,1758688756580510127,1758688756626546062,46.036,463,487,2048,966,3014,37,37,2048,0.23779296875,1561
179,1758689357770813308,1758689357820736391,49.923,459,483,2044,966,3010,37,37,2044,0.2363013698630137,1561
180,1758689955968534166,1758689956143728128,175.194,463,487,2048,966,3014,37,37,2048,0.23779296875,1561
181,1758690559188867065,1758690559489709773,300.843,463,487,2048,966,3014,37,37,2048,0.23779296875,1561
182,1758691158402173232,1758691158496025394,93.852,459,483,2196,1146,3342,42,42,2196,0.21994535519125682,1713
183,1758691759598318513,1758691759760878136,162.56,463,487,1972,902,2874,35,35,1972,0.24695740365111563,1485
184,1758692359788374220,1758692360082672349,294.298,463,487,1896,838,2734,33,33,1896,0.2568565400843882,1409
185,1758692955988484619,1758692956109766685,121.282,463,487,1972,954,2926,36,36,1972,0.24695740365111563,1485
186,1758693556202661239,1758693556308890401,106.229,463,487,2200,1146,3346,42,42,2200,0.22136363636363637,1713
187,1758694156414876222,1758694157467703428,1052.827,459,483,2756,1158,3914,43,43,2756,0.17525399129172714,2273
188,1758694756620664555,1758694756850398533,229.734,463,487,2048,966,3014,37,37,2048,0.23779296875,1561
189,1758695356817980985,1758695357079775556,261.795,463,487,1972,902,2874,35,35,1972,0.24695740365111563,1485
190,1758695956019253622,1758695956279530349,260.277,463,487,2124,1030,3154,39,39,2124,0.2292843691148776,1637
191,1758696556217939423,1758696557858196844,1640.257,463,487,2460,954,3414,36,36,2460,0.19796747967479675,1973
192,1758697157424457244,1758697157517209181,92.752,463,487,2124,1030,3154,39,39,2124,0.2292843691148776,1637
193,1758697756629648394,1758697756644073301,14.425,463,487,1896,838,2734,33,33,1896,0.2568565400843882,1409
194,1758698355827385783,1758698355998803427,171.418,463,487,2148,1134,3282,41,41,2148,0.22672253258845437,1661
195,1758698957039682401,1758698958506418584,1466.736,463,487,2124,1030,3154,39,39,2124,0.2292843691148776,1637
196,1758699556248521017,1758699556463217431,214.696,463,487,1972,902,2874,35,35,1972,0.24695740365111563,1485
197,1758700156442732410,1758700156549973483,107.241,463,487,1896,838,2734,33,33,1896,0.2568565400843882,1409
198,1758700756621889131,1758700756723906390,102.017,463,487,2124,1082,3206,40,40,2124,0.2292843691148776,1637
199,1758701358821080260,1758701358882648824,61.569,463,487,2048,966,3014,37,37,2048,0.23779296875,1561
200,1758701956030328778,1758701956351093997,320.765,463,487,2048,966,3014,37,37,2048,0.23779296875,1561
201,1758702556227271790,1758702556549231464,321.96,463,487,1972,902,2874,35,35,1972,0.24695740365111563,1485
202,1758703157432287257,1758703157750659160,318.372,463,487,2124,1082,3206,40,40,2124,0.2292843691148776,1637
203,1758703756634617232,1758703756910968081,276.351,463,487,1896,838,2734,33,33,1896,0.2568565400843882,1409
204,1758704355830199081,1758704356042812746,212.614,463,487,2124,1082,3206,40,40,2124,0.2292843691148776,1637
205,1758704956039957370,1758704956364908327,324.951,459,483,2120,1030,3150,39,39,2120,0.2278301886792453,1637
206,1758705556241339695,1758705556498433705,257.094,463,487,2304,1270,3574,45,45,2304,0.2113715277777778,1817
207,1758706156444808725,1758706156681034933,236.226,463,487,1896,838,2734,33,33,1896,0.2568565400843882,1409
208,1758706756643954314,1758706756707039563,63.085,463,487,1896,838,2734,33,33,1896,0.2568565400843882,1409
209,1758707355834570963,1758707355895957097,61.386,463,487,1896,838,2734,33,33,1896,0.2568565400843882,1409
210,1758707956042967394,1758707956344114197,301.147,463,487,1896,838,2734,33,33,1896,0.2568565400843882,1409
211,1758708556256163630,1758708556473452029,217.288,463,487,1896,838,2734,33,33,1896,0.2568565400843882,1409
212,1758709156455271007,1758709156517254686,61.984,463,487,1896,838,2734,33,33,1896,0.2568565400843882,1409
213,1758709756640784948,1758709756960083989,319.299,463,487,1896,838,2734,33,33,1896,0.2568565400843882,1409
214,1758710355845719488,1758710355899543149,53.824,463,487,2124,1082,3206,40,40,2124,0.2292843691148776,1637
215,1758710956064240617,1758710956073210321,8.97,463,487,1896,838,2734,33,33,1896,0.2568565400843882,1409
216,1758711556271715627,1758711556294674839,22.959,459,483,1764,762,2526,30,30,1764,0.27380952380952384,1281
217,1758712156464404378,1758712156726376226,261.972,463,487,1896,838,2734,33,33,1896,0.2568565400843882,1409
218,1758712755668936939,1758712755912958717,244.022,467,491,2052,1018,3070,38,38,2052,0.23927875243664717,1561
219,1758713355872765107,1758713356086655074,213.89,463,487,2188,1042,3230,40,40,2188,0.22257769652650822,1701
220,1758713956095438962,1758713956363730884,268.292,467,491,1976,954,2930,36,36,1976,0.24848178137651822,1485
221,1758714556295688887,1758714556570787175,275.098,467,491,1976,902,2878,35,35,1976,0.24848178137651822,1485
222,1758715156478394654,1758715156781704284,303.31,467,491,2128,1082,3210,40,40,2128,0.23073308270676693,1637
223,1758715756683259961,1758715756912218562,228.959,463,487,2048,966,3014,37,37,2048,0.23779296875,1561
224,1758716356883319376,1758716357057680970,174.362,467,491,1900,838,2738,33,33,1900,0.25842105263157894,1409
225,1758716956104454825,1758716956255987565,151.533,467,491,1900,838,2738,33,33,1900,0.25842105263157894,1409
226,1758717556294154812,1758717556434241852,140.087,467,491,1900,838,2738,33,33,1900,0.25842105263157894,1409
227,1758718156501768859,1758718156649827763,148.059,467,491,1900,838,2738,33,33,1900,0.25842105263157894,1409
228,1758718756708788063,1758718756894533878,185.746,467,491,1900,838,2738,33,33,1900,0.25842105263157894,1409
229,1758719355912311082,1758719356162871241,250.56,467,491,1900,838,2738,33,33,1900,0.25842105263157894,1409
230,1758719956130493790,1758719956401839784,271.346,467,491,1900,838,2738,33,33,1900,0.25842105263157894,1409
231,1758720556327900892,1758720556609886095,281.985,463,487,1896,838,2734,33,33,1896,0.2568565400843882,1409
232,1758721156536048404,1758721156813694654,277.646,467,491,1976,902,2878,35,35,1976,0.24848178137651822,1485
233,1758721755747623249,1758721755915778980,168.156,467,491,1900,838,2738,33,33,1900,0.25842105263157894,1409
234,1758722357954172570,1758722358021996545,67.824,467,491,1900,838,2738,33,33,1900,0.25842105263157894,1409
235,1758722956169480778,1758722956256814988,87.334,463,487,1896,838,2734,33,33,1896,0.2568565400843882,1409
236,1758723556382393183,1758723556456121781,73.729,467,491,1900,838,2738,33,33,1900,0.25842105263157894,1409
237,1758724156568979812,1758724156583522170,14.542,467,491,1900,838,2738,33,33,1900,0.25842105263157894,1409
238,1758724756751674384,1758724756933639671,181.965,467,491,1900,838,2738,33,33,1900,0.25842105263157894,1409
239,1758725355962015383,1758725355976108136,14.093,463,487,1768,762,2530,30,30,1768,0.2754524886877828,1281
240,1758725956178758751,1758725956509002825,330.244,467,491,2052,1018,3070,38,38,2052,0.23927875243664717,1561
241,1758726556388872992,1758726556642819381,253.946,467,491,1900,838,2738,33,33,1900,0.25842105263157894,1409
242,1758727155586533896,1758727155871321303,284.787,467,491,1900,838,2738,33,33,1900,0.25842105263157894,1409
243,1758727755766628581,1758727755863616245,96.988,463,487,1896,838,2734,33,33,1896,0.2568565400843882,1409
244,1758728355977096982,1758728356105588745,128.492,467,491,1900,838,2738,33,33,1900,0.25842105263157894,1409
245,1758728956195629407,1758728956311831840,116.202,467,491,1900,838,2738,33,33,1900,0.25842105263157894,1409
246,1758729556403262492,1758729556731473053,328.211,467,491,1900,838,2738,33,33,1900,0.25842105263157894,1409
247,1758730156607642565,1758730156857996675,250.354,467,491,1900,838,2738,33,33,1900,0.25842105263157894,1409
248,1758730756798189924,1758730757014871078,216.681,467,491,1976,902,2878,35,35,1976,0.24848178137651822,1485
249,1758731356009935082,1758731356123219020,113.284,467,491,2204,1094,3298,41,41,2204,0.22277676950998185,1713
250,1758731956222707889,1758731956296722880,74.015,463,487,1896,838,2734,33,33,1896,0.2568565400843882,1409
251,1758732556434206955,1758732556635626159,201.419,467,491,1964,914,2878,35,35,1964,0.25,1473
252,1758733155630853033,1758733155874427901,243.575,467,491,1900,838,2738,33,33,1900,0.25842105263157894,1409
253,1758733756819311687,1758733756996116223,176.805,463,487,1896,838,2734,33,33,1896,0.2568565400843882,1409
254,1758734356033667240,1758734356192488424,158.821,463,487,1896,838,2734,33,33,1896,0.2568565400843882,1409
255,1758734956247511847,1758734956511668803,264.157,467,491,1900,838,2738,33,33,1900,0.25842105263157894,1409
256,1758735556458560967,1758735556572448730,113.888,467,491,1900,838,2738,33,33,1900,0.25842105263157894,1409
257,1758736156654162216,1758736156916051636,261.889,463,487,1896,838,2734,33,33,1896,0.2568565400843882,1409
258,1758736755852369647,1758736755957643283,105.274,467,491,1900,838,2738,33,33,1900,0.25842105263157894,1409
259,1758737356061459767,1758737356228372517,166.913,467,491,1976,902,2878,35,35,1976,0.24848178137651822,1485
260,1758737956249678869,1758737956501135345,251.456,463,487,1896,838,2734,33,33,1896,0.2568565400843882,1409
261,1758738556460263196,1758738556772300263,312.037,467,491,1900,838,2738,33,33,1900,0.25842105263157894,1409
262,1758739156667605908,1758739156685086913,17.481,463,487,1896,838,2734,33,33,1896,0.2568565400843882,1409
263,1758739756874008227,1758739757006019921,132.012,463,487,1844,826,2670,32,32,1844,0.26409978308026033,1357
264,1758740356094662779,1758740356229053291,134.391,463,487,2148,1146,3294,41,41,2148,0.22672253258845437,1661
265,1758740956310814111,1758740956484121020,173.307,467,491,1900,838,2738,33,33,1900,0.25842105263157894,1409
266,1758741556514802972,1758741556576834058,62.031,463,487,1896,838,2734,33,33,1896,0.2568565400843882,1409
267,1758742155707117630,1758742155972474528,265.357,463,487,1896,838,2734,33,33,1896,0.2568565400843882,1409
268,1758742755916652573,1758742756007831541,91.179,467,491,1900,838,2738,33,33,1900,0.25842105263157894,1409
269,1758743356130610742,1758743356393397958,262.787,467,491,1900,838,2738,33,33,1900,0.25842105263157894,1409
270,1758743956345214746,1758743956540377952,195.163,467,491,1900,838,2738,33,33,1900,0.25842105263157894,1409
271,1758744556546383091,1758744556812556665,266.174,467,491,2052,966,3018,37,37,2052,0.23927875243664717,1561
272,1758745156735564573,1758745156989739881,254.175,467,491,1900,838,2738,33,33,1900,0.25842105263157894,1409
273,1758745755948346221,1758745756032366204,84.02,467,491,1976,902,2878,35,35,1976,0.24848178137651822,1485
274,1758746356170384264,1758746356303618159,133.234,463,487,1896,838,2734,33,33,1896,0.2568565400843882,1409
275,1758746956388788057,1758746956575613965,186.826,467,491,1900,838,2738,33,33,1900,0.25842105263157894,1409
276,1758747556601116291,1758747556846351841,245.236,467,491,1900,838,2738,33,33,1900,0.25842105263157894,1409
277,1758748156807448398,1758748157019336984,211.889,467,491,1900,838,2738,33,33,1900,0.25842105263157894,1409
278,1758748756018817872,1758748756138005353,119.187,467,491,1900,838,2738,33,33,1900,0.25842105263157894,1409
279,1758749356216744422,1758749356465525877,248.781,467,491,1900,838,2738,33,33,1900,0.25842105263157894,1409
280,1758749956428633973,1758749956736624041,307.99,463,487,1896,838,2734,33,33,1896,0.2568565400843882,1409
281,1758750556637608999,1758750556691740259,54.131,467,491,1900,838,2738,33,33,1900,0.25842105263157894,1409
282,1758751155848699382,1758751156036867304,188.168,467,491,2384,1386,3770,48,48,2384,0.20595637583892618,1893
283,1758751756067811655,1758751756310157577,242.346,467,491,1900,838,2738,33,33,1900,0.25842105263157894,1409
284,1758752356280874828,1758752356582446521,301.572,467,491,1900,838,2738,33,33,1900,0.25842105263157894,1409
285,1758752956490036854,1758752956554365678,64.329,467,491,1900,838,2738,33,33,1900,0.25842105263157894,1409
286,1758753555693015422,1758753555706744128,13.729,463,487,2152,1142,3294,41,41,2152,0.22630111524163568,1665
287,1758754155886898822,1758754156484736342,597.838,467,491,2468,902,3370,35,35,2468,0.19894651539708266,1977
288,1758754756102164247,1758754756115535615,13.371,467,491,1772,762,2534,30,30,1772,0.2770880361173815,1281
289,1758755356288236619,1758755356560103644,271.867,467,491,1900,838,2738,33,33,1900,0.25842105263157894,1409
290,1758755956498893646,1758755956743402288,244.509,467,491,1900,838,2738,33,33,1900,0.25842105263157894,1409
291,1758756556709013744,1758756557011944266,302.931,463,487,1896,838,2734,33,33,1896,0.2568565400843882,1409
292,1758757155918049302,1758757156054193562,136.144,467,491,1900,838,2738,33,33,1900,0.25842105263157894,1409
293,1758757756140149440,1758757756309114676,168.965,467,491,1900,838,2738,33,33,1900,0.25842105263157894,1409
294,1758758356354907648,1758758356580954984,226.047,467,491,1900,838,2738,33,33,1900,0.25842105263157894,1409
295,1758758956565023170,1758758956851529815,286.507,463,487,1896,838,2734,33,33,1896,0.2568565400843882,1409
296,1758759555767835824,1758759555875521468,107.686,463,487,1896,838,2734,33,33,1896,0.2568565400843882,1409
297,1758760155981835214,1758760156290616253,308.781,463,487,1896,838,2734,33,33,1896,0.2568565400843882,1409
298,1758760756198346185,1758760756486245971,287.9,463,487,1896,838,2734,33,33,1896,0.2568565400843882,1409
299,1758761356397563377,1758761356568648204,171.085,463,487,1896,838,2734,33,33,1896,0.2568565400843882,1409
300,1758761956582256093,1758761956809251100,226.995,463,487,2200,1082,3282,41,41,2200,0.22136363636363637,1713
301,1758762556790063558,1758762556915740874,125.677,459,483,1968,902,2870,35,35,1968,0.24542682926829268,1485
302,1758763156004001404,1758763156261865261,257.864,463,487,1896,838,2734,33,33,1896,0.2568565400843882,1409
303,1758763756216666030,1758763756499527574,282.862,463,487,1896,838,2734,33,33,1896,0.2568565400843882,1409
304,1758764356424711857,1758764356629765741,205.054,463,487,1896,838,2734,33,33,1896,0.2568565400843882,1409
305,1758764956617496967,1758764956750815538,133.319,463,487,2152,1142,3294,41,41,2152,0.22630111524163568,1665
306,1758765556803944290,1758765557069180099,265.236,463,487,1896,838,2734,33,33,1896,0.2568565400843882,1409
307,1758766156015216960,1758766156302574388,287.357,463,487,2088,1066,3154,39,39,2088,0.2332375478927203,1601
308,1758766756234635862,1758766756379531330,144.895,459,483,1892,838,2730,33,33,1892,0.25528541226215645,1409
309,1758767356447239662,1758767356615919638,168.68,463,487,1896,838,2734,33,33,1896,0.2568565400843882,1409
310,1758767956652947104,1758767956847741519,194.794,463,487,1896,838,2734,33,33,1896,0.2568565400843882,1409
311,1758768555847936007,1758768555858433840,10.498,463,487,1896,838,2734,33,33,1896,0.2568565400843882,1409
312,1758769156056989288,1758769156165272153,108.283,459,483,1892,838,2730,33,33,1892,0.25528541226215645,1409
313,1758769756247925054,1758769756318976299,71.051,463,487,1896,838,2734,33,33,1896,0.2568565400843882,1409
314,1758770356454697587,1758770356468473670,13.776,463,487,1768,762,2530,30,30,1768,0.2754524886877828,1281
315,1758770956658663456,1758770956726357229,67.694,459,483,1892,838,2730,33,33,1892,0.25528541226215645,1409
316,1758771555856724264,1758771556072831073,216.107,463,487,2124,1018,3142,39,39,2124,0.2292843691148776,1637
317,1758772156069720030,1758772156367377521,297.657,463,487,1896,838,2734,33,33,1896,0.2568565400843882,1409
318,1758772756270070234,1758772756530713765,260.644,463,487,2048,966,3014,37,37,2048,0.23779296875,1561
319,1758773357477811274,1758773357569268295,91.457,459,483,1892,890,2782,34,34,1892,0.25528541226215645,1409
320,1758773956685230101,1758773956963459591,278.229,463,487,2124,1030,3154,39,39,2124,0.2292843691148776,1637
321,1758774556883425289,1758774557014164336,130.739,463,487,2048,1018,3066,38,38,2048,0.23779296875,1561
322,1758775156100496560,1758775158130118387,2029.622,463,487,3100,1030,4130,39,39,3100,0.1570967741935484,2613
323,1758775756308958851,1758775756592378880,283.42,463,487,2152,1142,3294,41,41,2152,0.22630111524163568,1665
324,1758776356501088953,1758776356589077777,87.989,463,487,2048,966,3014,37,37,2048,0.23779296875,1561
325,1758776956708157592,1758776956961728316,253.571,463,487,2036,978,3014,37,37,2036,0.23919449901768172,1549
326,1758777555907350208,1758777556108934305,201.584,463,487,2124,1030,3154,39,39,2124,0.2292843691148776,1637
327,1758778156129766413,1758778156273466423,143.7,463,487,1972,902,2874,35,35,1972,0.24695740365111563,1485
328,1758778757338773712,1758778757576526870,237.753,463,487,1896,838,2734,33,33,1896,0.2568565400843882,1409
329,1758779357542844460,1758779357837063773,294.219,463,487,1896,838,2734,33,33,1896,0.2568565400843882,1409
330,1758779956734144463,1758779957056508680,322.364,463,487,2200,1146,3346,42,42,2200,0.22136363636363637,1713
331,1758780555933693546,1758780556009253982,75.56,463,487,2048,1018,3066,38,38,2048,0.23779296875,1561
332,1758781156129809173,1758781156248096896,118.288,463,487,2048,966,3014,37,37,2048,0.23779296875,1561
333,1758781756343897845,1758781756354392061,10.494,463,487,1972,954,2926,36,36,1972,0.24695740365111563,1485
334,1758782356550273966,1758782356861618941,311.345,463,487,1896,838,2734,33,33,1896,0.2568565400843882,1409
335,1758782956749100875,1758782957039964512,290.864,463,487,1768,762,2530,30,30,1768,0.2754524886877828,1281
336,1758783555948343645,1758783556109066553,160.723,459,483,2120,1082,3202,40,40,2120,0.2278301886792453,1637
337,1758784156153767644,1758784156427374394,273.607,463,487,2048,966,3014,37,37,2048,0.23779296875,1561
338,1758784756341581427,1758784756470384033,128.803,463,487,2124,1030,3154,39,39,2124,0.2292843691148776,1637
339,1758785356522178838,1758785356729190822,207.012,463,487,1896,838,2734,33,33,1896,0.2568565400843882,1409
340,1758785956725147460,1758785956800650300,75.503,463,487,2048,1018,3066,38,38,2048,0.23779296875,1561
341,1758786555927920079,1758786556226835871,298.916,463,487,2380,1386,3766,48,48,2380,0.2046218487394958,1893
342,1758787156149789892,1758787156338059512,188.27,463,487,1896,838,2734,33,33,1896,0.2568565400843882,1409
343,1758787756360493727,1758787756400606596,40.113,463,487,2124,1030,3154,39,39,2124,0.2292843691148776,1637
344,1758788356557425647,1758788356671363750,113.938,463,487,2200,1198,3398,43,43,2200,0.22136363636363637,1713
345,1758788955760416289,1758788955897504579,137.088,463,487,1972,902,2874,35,35,1972,0.24695740365111563,1485
346,1758789555968838981,1758789556083191045,114.352,463,487,1896,838,2734,33,33,1896,0.2568565400843882,1409
347,1758790156186449494,1758790156356094304,169.645,463,487,1896,838,2734,33,33,1896,0.2568565400843882,1409
348,1758790756396451578,1758790756583100461,186.649,463,487,2124,1030,3154,39,39,2124,0.2292843691148776,1637
349,1758791356597966361,1758791356697688853,99.722,459,483,1968,954,2922,36,36,1968,0.24542682926829268,1485
350,1758791955788986965,1758791956057172855,268.186,459,483,2044,966,3010,37,37,2044,0.2363013698630137,1561
351,1758792555988758297,1758792556260811705,272.053,463,487,1896,838,2734,33,33,1896,0.2568565400843882,1409
352,1758793156190783303,1758793156205225031,14.442,463,487,1896,838,2734,33,33,1896,0.2568565400843882,1409
353,1758793756403171201,1758793756657687365,254.516,463,487,1844,826,2670,32,32,1844,0.26409978308026033,1357
354,1758794355612075744,1758794355895580408,283.505,463,487,1844,838,2682,32,32,1844,0.26409978308026033,1357
355,1758794956815350275,1758794957061122332,245.772,459,483,1968,902,2870,35,35,1968,0.24542682926829268,1485
356,1758795556024763668,1758795556218030120,193.266,463,487,2048,966,3014,37,37,2048,0.23779296875,1561
357,1758796156240737160,1758796156530702168,289.965,463,487,1896,838,2734,33,33,1896,0.2568565400843882,1409
358,1758796756429832492,1758796756704832122,275.0,459,483,1892,838,2730,33,33,1892,0.25528541226215645,1409
359,1758797356638813151,1758797356787409789,148.597,459,483,2120,1082,3202,40,40,2120,0.2278301886792453,1637
360,1758797955842573678,1758797956029272107,186.698,463,487,1896,838,2734,33,33,1896,0.2568565400843882,1409
361,1758798556058873725,1758798556378741118,319.867,463,487,2276,1262,3538,45,45,2276,0.2139718804920914,1789
362,1758799156261313386,1758799156417237846,155.924,463,487,1972,902,2874,35,35,1972,0.24695740365111563,1485
363,1758799756446910439,1758799756675064718,228.154,463,487,1896,838,2734,33,33,1896,0.2568565400843882,1409
364,1758800356632137653,1758800356898907390,266.77,463,487,2200,1146,3346,42,42,2200,0.22136363636363637,1713
365,1758800955836202039,1758800955900548015,64.346,463,487,1972,902,2874,35,35,1972,0.24695740365111563,1485
366,1758801556051976050,1758801556185472304,133.496,463,487,1896,838,2734,33,33,1896,0.2568565400843882,1409
367,1758802156266216334,1758802156491182994,224.967,463,487,1896,838,2734,33,33,1896,0.2568565400843882,1409
368,1758802756467176543,1758802756595343451,128.167,463,487,1972,902,2874,35,35,1972,0.24695740365111563,1485
369,1758803356661749870,1758803356932552101,270.802,459,483,1892,838,2730,33,33,1892,0.25528541226215645,1409
370,1758803956852968774,1758803957080789499,227.821,459,483,1892,838,2730,33,33,1892,0.25528541226215645,1409
371,1758804556042645316,1758804556115567857,72.923,463,487,1896,838,2734,33,33,1896,0.2568565400843882,1409
372,1758805156258696020,1758805156271223783,12.528,463,487,2124,1082,3206,40,40,2124,0.2292843691148776,1637
373,1758805756466750106,1758805756591561161,124.811,463,487,1896,838,2734,33,33,1896,0.2568565400843882,1409
374,1758806356675898994,1758806356688891450,12.992,463,487,1844,826,2670,32,32,1844,0.26409978308026033,1357
375,1758806955873531338,1758806956068595676,195.064,463,487,2188,1158,3346,42,42,2188,0.22257769652650822,1701
376,1758807556089372229,1758807556348495854,259.124,459,483,2196,1146,3342,42,42,2196,0.21994535519125682,1713
377,1758808156282313297,1758808156519439679,237.126,463,487,1896,838,2734,33,33,1896,0.2568565400843882,1409
378,1758808756486927126,1758808756749819314,262.892,463,487,2048,1018,3066,38,38,2048,0.23779296875,1561
379,1758809356695232709,1758809356809812774,114.58,463,487,1896,838,2734,33,33,1896,0.2568565400843882,1409
380,1758809955895257032,1758809956019972918,124.716,463,487,2048,966,3014,37,37,2048,0.23779296875,1561
381,1758810556111279739,1758810556350672481,239.393,467,491,2052,966,3018,37,37,2052,0.23927875243664717,1561
382,1758811158313717470,1758811158540150055,226.433,463,487,1896,890,2786,34,34,1896,0.2568565400843882,1409
383,1758811756498175416,1758811756729932827,231.757,467,491,1900,838,2738,33,33,1900,0.25842105263157894,1409
384,1758812356677562820,1758812356884595731,207.033,463,487,1896,838,2734,33,33,1896,0.2568565400843882,1409
385,1758812955878761771,1758812957783859659,1905.098,463,487,3816,1222,5038,45,45,3816,0.12762054507337525,3329
386,1758813556100338230,1758813556303584549,203.246,459,483,1892,838,2730,33,33,1892,0.25528541226215645,1409
387,1758814156312347358,1758814156440671377,128.324,459,483,1892,838,2730,33,33,1892,0.25528541226215645,1409
388,1758814756500267165,1758814756737489592,237.222,459,483,1892,838,2730,33,33,1892,0.25528541226215645,1409
389,1758815355681414751,1758815355922125178,240.71,463,487,1896,838,2734,33,33,1896,0.2568565400843882,1409
390,1758815956883936076,1758815957071965107,188.029,463,487,1896,838,2734,33,33,1896,0.2568565400843882,1409
391,1758816556101350613,1758816556113845745,12.495,463,487,1896,838,2734,33,33,1896,0.2568565400843882,1409
392,1758817156313088204,1758817156382634865,69.547,463,487,1896,838,2734,33,33,1896,0.2568565400843882,1409
393,1758817756501062125,1758817756514614703,13.553,459,483,1764,762,2526,30,30,1764,0.27380952380952384,1281
394,1758818356709846058,1758818357007418289,297.572,467,491,1900,838,2738,33,33,1900,0.25842105263157894,1409
395,1758818955921739766,1758818955978054840,56.315,467,491,1900,838,2738,33,33,1900,0.25842105263157894,1409
396,1758819556144236746,1758819556240111722,95.875,467,491,1976,902,2878,35,35,1976,0.24848178137651822,1485
397,1758820156360478598,1758820156510621141,150.143,467,491,1900,838,2738,33,33,1900,0.25842105263157894,1409
398,1758820756572153133,1758820756785960924,213.808,467,491,1900,838,2738,33,33,1900,0.25842105263157894,1409
399,1758821356773571490,1758821356821783773,48.212,467,491,1900,838,2738,33,33,1900,0.25842105263157894,1409
400,1758821955985849018,1758821956173345728,187.497,467,491,1900,838,2738,33,33,1900,0.25842105263157894,1409
401,1758822556200826450,1758822556440699254,239.873,467,491,1900,838,2738,33,33,1900,0.25842105263157894,1409
402,1758823156401289870,1758823156712095760,310.806,467,491,1900,838,2738,33,33,1900,0.25842105263157894,1409
403,1758823756594860366,1758823756674894150,80.034,467,491,1900,838,2738,33,33,1900,0.25842105263157894,1409
404,1758824356784219991,1758824356943042610,158.823,467,491,1900,838,2738,33,33,1900,0.25842105263157894,1409
405,1758824955982173872,1758824956292884202,310.71,463,487,1896,838,2734,33,33,1896,0.2568565400843882,1409
406,1758825556197615376,1758825556256193479,58.578,463,487,1896,838,2734,33,33,1896,0.2568565400843882,1409
407,1758826156410200261,1758826156528360733,118.16,463,487,1896,838,2734,33,33,1896,0.2568565400843882,1409
408,1758826756620828676,1758826756799822919,178.994,467,491,1900,838,2738,33,33,1900,0.25842105263157894,1409
409,1758827356829465497,1758827357072114056,242.649,467,491,1900,838,2738,33,33,1900,0.25842105263157894,1409
410,1758827956047620340,1758827956114559634,66.939,467,491,1900,838,2738,33,33,1900,0.25842105263157894,1409
411,1758828557267330776,1758828557309769187,42.438,463,487,2276,1210,3486,44,44,2276,0.2139718804920914,1789
412,1758829156477955070,1758829156524885485,46.93,467,491,1976,902,2878,35,35,1976,0.24848178137651822,1485
413,1758829756679966479,1758829756728397295,48.431,467,491,2204,1094,3298,41,41,2204,0.22277676950998185,1713
414,1758830355874524497,1758830356085374688,210.85,463,487,2048,966,3014,37,37,2048,0.23779296875,1561
415,1758830956093844610,1758830956106604822,12.76,467,491,2052,1070,3122,39,39,2052,0.23927875243664717,1561
416,1758831556292288363,1758831556302218313,9.93,467,491,2128,1030,3158,39,39,2128,0.23073308270676693,1637
417,1758832156480289259,1758832158277010872,1796.722,467,491,2468,954,3422,36,36,2468,0.19894651539708266,1977
418,1758832756677998462,1758832756692972741,14.974,467,491,1772,762,2534,30,30,1772,0.2770880361173815,1281
419,1758833356867812771,1758833357106475470,238.663,467,491,1900,838,2738,33,33,1900,0.25842105263157894,1409
420,1758833956086320216,1758833956376129327,289.809,463,487,1896,838,2734,33,33,1896,0.2568565400843882,1409
421,1758834556302846487,1758834556429542014,126.696,463,487,1896,838,2734,33,33,1896,0.2568565400843882,1409
422,1758835156516727680,1758835156748027072,231.299,467,491,2052,1018,3070,38,38,2052,0.23927875243664717,1561
423,1758835756708449830,1758835756983765916,275.316,467,491,1900,838,2738,33,33,1900,0.25842105263157894,1409
424,1758836355919688788,1758836356023594502,103.906,463,487,1896,838,2734,33,33,1896,0.2568565400843882,1409
425,1758836957139902812,1758836957527484780,387.582,467,491,2468,902,3370,35,35,2468,0.19894651539708266,1977
426,1758837556353897527,1758837556566603359,212.706,463,487,1896,838,2734,33,33,1896,0.2568565400843882,1409
427,1758838156565621378,1758838156837960075,272.339,467,491,1900,838,2738,33,33,1900,0.25842105263157894,1409
428,1758838756768805232,1758838756803117616,34.312,467,491,1900,838,2738,33,33,1900,0.25842105263157894,1409
429,1758839355970899376,1758839356069491107,98.592,467,491,1976,902,2878,35,35,1976,0.24848178137651822,1485
430,1758839956162607791,1758839956483744196,321.136,467,491,1900,838,2738,33,33,1900,0.25842105263157894,1409
431,1758840556371702714,1758840556659032728,287.33,463,487,1896,838,2734,33,33,1896,0.2568565400843882,1409
432,1758841156579721984,1758841156624140658,44.419,467,491,1900,838,2738,33,33,1900,0.25842105263157894,1409
433,1758841755779667495,1758841755970678441,191.011,467,491,1900,838,2738,33,33,1900,0.25842105263157894,1409
434,1758842355979758064,1758842356242771470,263.013,467,491,1900,838,2738,33,33,1900,0.25842105263157894,1409
435,1758842956197315633,1758842956513189667,315.874,467,491,1900,838,2738,33,33,1900,0.25842105263157894,1409
436,1758843556394854592,1758843556480058061,85.203,463,487,1972,902,2874,35,35,1972,0.24695740365111563,1485
437,1758844156586344684,1758844156693471704,107.127,463,487,1972,902,2874,35,35,1972,0.24695740365111563,1485
438,1758844755772212057,1758844755935348237,163.136,467,491,2204,1198,3402,43,43,2204,0.22277676950998185,1713
439,1758845355996122120,1758845356011090501,14.968,467,491,2052,1018,3070,38,38,2052,0.23927875243664717,1561
440,1758845956218946517,1758845956376746935,157.8,467,491,2128,1030,3158,39,39,2128,0.23073308270676693,1637
441,1758846556410240647,1758846556425680980,15.44,467,491,1924,942,2866,35,35,1924,0.25519750519750517,1433
442,1758847156618625646,1758847156823938273,205.313,467,491,1900,838,2738,33,33,1900,0.25842105263157894,1409
443,1758847756823666753,1758847757053640499,229.974,459,483,1892,838,2730,33,33,1892,0.25528541226215645,1409
444,1758848356035125951,1758848356247577577,212.452,463,487,1896,838,2734,33,33,1896,0.2568565400843882,1409
445,1758848956246292150,1758848956539130316,292.838,463,487,1896,838,2734,33,33,1896,0.2568565400843882,1409
446,1758849556441648517,1758849556760084974,318.436,459,483,1892,838,2730,33,33,1892,0.25528541226215645,1409
447,1758850155644110976,1758850155650621731,6.511,463,487,1896,838,2734,33,33,1896,0.2568565400843882,1409
448,1758850756845182102,1758850756968595935,123.414,463,487,1896,838,2734,33,33,1896,0.2568565400843882,1409
449,1758851356052076772,1758851356334573036,282.496,463,487,1972,902,2874,35,35,1972,0.24695740365111563,1485
450,1758851956259454531,1758851956456681953,197.227,459,483,2120,1030,3150,39,39,2120,0.2278301886792453,1637
451,1758852556441627378,1758852556597482418,155.855,463,487,2048,1018,3066,38,38,2048,0.23779296875,1561
452,1758853156644894306,1758853156789519859,144.626,463,487,1896,838,2734,33,33,1896,0.2568565400843882,1409
453,1758853756838715802,1758853757149917851,311.202,463,487,1896,838,2734,33,33,1896,0.2568565400843882,1409
454,1758854356044917473,1758854356225540826,180.623,463,487,2200,1146,3346,42,42,2200,0.22136363636363637,1713
455,1758854956235838262,1758854956412084003,176.246,463,487,2048,966,3014,37,37,2048,0.23779296875,1561
456,1758855556443387877,1758855556552790668,109.403,463,487,2200,1198,3398,43,43,2200,0.22136363636363637,1713
457,1758856156638314510,1758856156672093227,33.779,463,487,1972,902,2874,35,35,1972,0.24695740365111563,1485
458,1758856756834653138,1758856757129829434,295.176,463,487,1896,838,2734,33,33,1896,0.2568565400843882,1409
459,1758857356042658340,1758857356357935584,315.277,463,487,2124,902,3026,37,37,2124,0.2292843691148776,1637
460,1758857958248782088,1758857958262021291,13.239,463,487,1896,838,2734,33,33,1896,0.2568565400843882,1409
461,1758858556433948219,1758858556692161040,258.213,463,487,2124,1082,3206,40,40,2124,0.2292843691148776,1637
462,1758859157641699488,1758859157651708657,10.009,459,483,1840,826,2666,32,32,1840,0.2625,1357
463,1758859756843735600,1758859757140696295,296.961,463,487,2428,1274,3702,47,47,2428,0.20057660626029655,1941
464,1758860356056493751,1758860356220187148,163.693,459,483,1892,838,2730,33,33,1892,0.25528541226215645,1409
465,1758860956269371302,1758860956298432868,29.062,463,487,2200,1094,3294,41,41,2200,0.22136363636363637,1713
466,1758861556460432878,1758861556576415241,115.982,463,487,2200,1146,3346,42,42,2200,0.22136363636363637,1713
467,1758862156669415119,1758862156919400158,249.985,459,483,2044,966,3010,37,37,2044,0.2363013698630137,1561
468,1758862756868408132,1758862757105685358,237.277,463,487,1972,902,2874,35,35,1972,0.24695740365111563,1485
469,1758863356085462888,1758863356321755289,236.292,463,487,2048,966,3014,37,37,2048,0.23779296875,1561
470,1758863957291063145,1758863957509453239,218.39,459,483,1956,914,2870,35,35,1956,0.2469325153374233,1473
471,1758864556480656704,1758864556756442194,275.785,459,483,2120,1082,3202,40,40,2120,0.2278301886792453,1637
472,1758865156686573306,1758865156814778546,128.205,463,487,2200,1146,3346,42,42,2200,0.22136363636363637,1713
473,1758865755887854584,1758865756093772437,205.918,463,487,2152,1150,3302,41,41,2152,0.22630111524163568,1665
474,1758866359106165632,1758866359180780220,74.615,463,487,1960,914,2874,35,35,1960,0.24846938775510205,1473
475,1758866956313721712,1758866956529309325,215.588,459,483,2120,1030,3150,39,39,2120,0.2278301886792453,1637
476,1758867556517669086,1758867556656098633,138.43,459,483,1892,838,2730,33,33,1892,0.25528541226215645,1409
477,1758868156703567939,1758868156994758619,291.191,463,487,2200,1146,3346,42,42,2200,0.22136363636363637,1713
478,1758868755887218769,1758868756090547619,203.329,463,487,1972,902,2874,35,35,1972,0.24695740365111563,1485
479,1758869356108401098,1758869356121233771,12.833,463,487,1920,826,2746,33,33,1920,0.25364583333333335,1433
480,1758869956322838781,1758869956493771329,170.933,463,487,2048,1018,3066,38,38,2048,0.23779296875,1561
481,1758870556523918602,1758870556666558636,142.64,463,487,2048,966,3014,37,37,2048,0.23779296875,1561
482,1758871156713740194,1758871156948611649,234.871,463,487,1896,838,2734,33,33,1896,0.2568565400843882,1409
483,1758871755898851810,1758871755966250317,67.399,463,487,1896,838,2734,33,33,1896,0.2568565400843882,1409
484,1758872356107114070,1758872356425088123,317.974,463,487,2124,1082,3206,40,40,2124,0.2292843691148776,1637
485,1758872956319167356,1758872956549755231,230.588,463,487,2048,966,3014,37,37,2048,0.23779296875,1561
486,1758873556530117809,1758873556781521534,251.404,463,487,1896,838,2734,33,33,1896,0.2568565400843882,1409
487,1758874157731121714,1758874157990379343,259.258,463,487,2124,1082,3206,40,40,2124,0.2292843691148776,1637
488,1758874755929180046,1758874756009073324,79.893,459,483,2120,1030,3150,39,39,2120,0.2278301886792453,1637
489,1758875356141273980,1758875356274236309,132.962,463,487,2124,1134,3258,41,41,2124,0.2292843691148776,1637
490,1758875956354087011,1758875956538862450,184.775,463,487,2048,966,3014,37,37,2048,0.23779296875,1561
491,1758876556560652311,1758876556884822472,324.17,463,487,1896,838,2734,33,33,1896,0.2568565400843882,1409
492,1758877156758949306,1758877156859844838,100.896,463,487,2200,1146,3346,42,42,2200,0.22136363636363637,1713
493,1758877755959845182,1758877756138420097,178.575,463,487,2124,1030,3154,39,39,2124,0.2292843691148776,1637
494,1758878356170857248,1758878356253544570,82.687,459,483,1968,902,2870,35,35,1968,0.24542682926829268,1485
495,1758878960364264160,1758878960661324526,297.06,463,487,2124,1030,3154,39,39,2124,0.2292843691148776,1637
496,1758879556547997989,1758879556560860050,12.862,463,487,1972,902,2874,35,35,1972,0.24695740365111563,1485
497,1758880156734133293,1758880156747151475,13.018,463,487,2124,1082,3206,40,40,2124,0.2292843691148776,1637
498,1758880755942295970,1758880755952111405,9.815,463,487,1844,826,2670,32,32,1844,0.26409978308026033,1357
499,1758881357168072130,1758881359568892213,2400.82,463,487,2460,902,3362,35,35,2460,0.19796747967479675,1973
500,1758881956372594183,1758881956580876800,208.283,467,491,1900,838,2738,33,33,1900,0.25842105263157894,1409
501,1758882556569548347,1758882556759835216,190.287,463,487,2124,1082,3206,40,40,2124,0.2292843691148776,1637
502,1758883156760152594,1758883156937058158,176.906,463,487,2048,966,3014,37,37,2048,0.23779296875,1561
503,1758883755971629380,1758883756040192598,68.563,459,483,2044,1070,3114,39,39,2044,0.2363013698630137,1561
504,1758884356191251311,1758884356259026929,67.776,463,487,1972,902,2874,35,35,1972,0.24695740365111563,1485
505,1758884956404069968,1758884956442446190,38.376,459,483,1968,902,2870,35,35,1968,0.24542682926829268,1485
506,1758885556612104232,1758885556672201289,60.097,463,487,2124,1030,3154,39,39,2124,0.2292843691148776,1637
507,1758886156807933871,1758886157063174127,255.24,463,487,1896,838,2734,33,33,1896,0.2568565400843882,1409
508,1758886758017806042,1758886758114566299,96.76,459,483,1892,838,2730,33,33,1892,0.25528541226215645,1409
509,1758887357206677219,1758887357433545270,226.868,463,487,2048,1018,3066,38,38,2048,0.23779296875,1561
510,1758887956416660288,1758887956621040866,204.381,463,487,1972,902,2874,35,35,1972,0.24695740365111563,1485
511,1758888556624562974,1758888556817354200,192.791,463,487,2152,1142,3294,41,41,2152,0.22630111524163568,1665
512,1758889155820934855,1758889156077406835,256.472,463,487,1896,838,2734,33,33,1896,0.2568565400843882,1409
513,1758889757020815642,1758889757183362895,162.547,463,487,2048,966,3014,37,37,2048,0.23779296875,1561
514,1758890356208790865,1758890356488404671,279.614,459,483,1892,838,2730,33,33,1892,0.25528541226215645,1409
515,1758890956417618394,1758890956626801187,209.183,463,487,1896,838,2734,33,33,1896,0.2568565400843882,1409
516,1758891559625584629,1758891559690295933,64.711,463,487,1972,902,2874,35,35,1972,0.24695740365111563,1485
517,1758892156821075066,1758892156835521033,14.446,463,487,1972,902,2874,35,35,1972,0.24695740365111563,1485
518,1758892756034039880,1758892756105133939,71.094,463,487,1972,902,2874,35,35,1972,0.24695740365111563,1485
519,1758893356236867313,1758893356249991551,13.124,459,483,1968,902,2870,35,35,1968,0.24542682926829268,1485
520,1758893959446757853,1758893959460016306,13.258,463,487,2072,1070,3142,39,39,2072,0.23503861003861004,1585
521,1758894556655212377,1758894556711553129,56.341,463,487,2048,966,3014,37,37,2048,0.23779296875,1561
522,1758895156852211683,1758895157150944979,298.733,463,487,1896,838,2734,33,33,1896,0.2568565400843882,1409
523,1758895756064734506,1758895756363321402,298.587,459,483,1968,902,2870,35,35,1968,0.24542682926829268,1485
524,1758896356251982207,1758896356437556069,185.574,463,487,2200,1094,3294,41,41,2200,0.22136363636363637,1713
525,1758896956460138188,1758896956514203205,54.065,467,491,1900,838,2738,33,33,1900,0.25842105263157894,1409
526,1758897556665193344,1758897556926405628,261.212,467,491,1900,838,2738,33,33,1900,0.25842105263157894,1409
527,1758898155859926511,1758898155968131807,108.205,467,491,1900,838,2738,33,33,1900,0.25842105263157894,1409
528,1758898756074124619,1758898756222311002,148.186,467,491,1900,838,2738,33,33,1900,0.25842105263157894,1409
529,1758899356270962858,1758899356388975657,118.013,467,491,1900,838,2738,33,33,1900,0.25842105263157894,1409
530,1758899956479882869,1758899956672026621,192.144,467,491,1900,838,2738,33,33,1900,0.25842105263157894,1409
531,1758900556691248920,1758900556983889926,292.641,467,491,1900,838,2738,33,33,1900,0.25842105263157894,1409
532,1758901155896387138,1758901156027457012,131.07,467,491,1900,838,2738,33,33,1900,0.25842105263157894,1409
533,1758901756116077099,1758901756298728649,182.652,467,491,1900,838,2738,33,33,1900,0.25842105263157894,1409
534,1758902356326330870,1758902356570052482,243.722,463,487,1896,838,2734,33,33,1896,0.2568565400843882,1409
535,1758902956526292447,1758902956841718709,315.426,463,487,1896,838,2734,33,33,1896,0.2568565400843882,1409
536,1758903556723844460,1758903556805613000,81.769,459,483,1892,838,2730,33,33,1892,0.25528541226215645,1409
537,1758904155913856778,1758904156155973470,242.117,459,483,1892,838,2730,33,33,1892,0.25528541226215645,1409
538,1758904756111145889,1758904756426458962,315.313,459,483,1892,838,2730,33,33,1892,0.25528541226215645,1409
539,1758905356292943583,1758905356390317116,97.374,459,483,1892,838,2730,33,33,1892,0.25528541226215645,1409
540,1758905956497942872,1758905956662693799,164.751,467,491,1900,838,2738,33,33,1900,0.25842105263157894,1409
541,1758906556706677965,1758906556935124999,228.447,463,487,1896,838,2734,33,33,1896,0.2568565400843882,1409
542,1758907156919761365,1758907157178727861,258.966,463,487,1896,838,2734,33,33,1896,0.2568565400843882,1409
543,1758907756142090903,1758907756221166452,79.076,463,487,1896,838,2734,33,33,1896,0.2568565400843882,1409
544,1758908356354063627,1758908356556534210,202.471,467,491,1976,902,2878,35,35,1976,0.24848178137651822,1485
545,1758908956552890364,1758908956566608309,13.718,467,491,1772,762,2534,30,30,1772,0.2770880361173815,1281
546,1758909556749969143,1758909557073180620,323.211,467,491,1900,838,2738,33,33,1900,0.25842105263157894,1409
547,1758910156945887659,1758910157155208335,209.321,463,487,1896,838,2734,33,33,1896,0.2568565400843882,1409
548,1758910756155759949,1758910756283181549,127.422,467,491,1900,838,2738,33,33,1900,0.25842105263157894,1409
549,1758911356369416252,1758911356500464382,131.048,467,491,1976,902,2878,35,35,1976,0.24848178137651822,1485
550,1758911956580006304,1758911956633404626,53.398,467,491,2280,1210,3490,44,44,2280,0.21535087719298246,1789
551,1758912555781046329,1758912556009969136,228.923,467,491,1900,838,2738,33,33,1900,0.25842105263157894,1409
552,1758913155986789853,1758913156137924941,151.135,467,491,1900,838,2738,33,33,1900,0.25842105263157894,1409
553,1758913756191742368,1758913756463119303,271.377,467,491,2128,1030,3158,39,39,2128,0.23073308270676693,1637
554,1758914356402084820,1758914356655647520,253.563,467,491,2052,966,3018,37,37,2052,0.23927875243664717,1561
555,1758914956608543352,1758914956671143877,62.601,467,491,1900,838,2738,33,33,1900,0.25842105263157894,1409
556,1758915556811581630,1758915557047574533,235.993,467,491,1900,838,2738,33,33,1900,0.25842105263157894,1409
557,1758916156025770802,1758916156122117841,96.347,463,487,1896,838,2734,33,33,1896,0.2568565400843882,1409
558,1758916756238948416,1758916756520865680,281.917,467,491,1900,838,2738,33,33,1900,0.25842105263157894,1409
559,1758917356438674736,1758917356553197065,114.522,467,491,2128,1082,3210,40,40,2128,0.23073308270676693,1637
560,1758917956621695709,1758917956668122828,46.427,467,491,1900,838,2738,33,33,1900,0.25842105263157894,1409
561,1758918556825147600,1758918557047798291,222.651,467,491,1900,838,2738,33,33,1900,0.25842105263157894,1409
562,1758919156041034333,1758919156229353804,188.319,463,487,1896,838,2734,33,33,1896,0.2568565400843882,1409
563,1758919756259404440,1758919756419616445,160.212,467,491,1900,838,2738,33,33,1900,0.25842105263157894,1409
564,1758920356473009529,1758920356668847882,195.838,467,491,1900,838,2738,33,33,1900,0.25842105263157894,1409
565,1758920956662576053,1758920956675522263,12.946,467,491,1900,838,2738,33,33,1900,0.25842105263157894,1409
566,1758921556845750672,1758921556917750976,72.0,463,487,1896,838,2734,33,33,1896,0.2568565400843882,1409
567,1758922156064033363,1758922156080792182,16.759,467,491,1772,762,2534,30,30,1772,0.2770880361173815,1281
568,1758922756280546779,1758922756351389914,70.843,467,491,1900,838,2738,33,33,1900,0.25842105263157894,1409
569,1758923356497370356,1758923356624139759,126.769,467,491,1900,838,2738,33,33,1900,0.25842105263157894,1409
570,1758923955701755295,1758923955973956640,272.201,467,491,1900,838,2738,33,33,1900,0.25842105263157894,1409
571,1758924556895096886,1758924557167674012,272.577,467,491,1900,838,2738,33,33,1900,0.25842105263157894,1409
572,1758925156111772278,1758925156208437338,96.665,467,491,1900,838,2738,33,33,1900,0.25842105263157894,1409
573,1758925756308070150,1758925756476803952,168.734,467,491,1900,838,2738,33,33,1900,0.25842105263157894,1409
574,1758926356491148467,1758926356746727415,255.579,467,491,1900,838,2738,33,33,1900,0.25842105263157894,1409
575,1758926956698272782,1758926957019079433,320.807,467,491,1900,838,2738,33,33,1900,0.25842105263157894,1409
576,1758927555903807357,1758927556060680139,156.873,467,491,1900,838,2738,33,33,1900,0.25842105263157894,1409
577,1758928156126187578,1758928156256352723,130.165,467,491,1900,838,2738,33,33,1900,0.25842105263157894,1409
578,1758928756343958307,1758928756528139620,184.181,463,487,2152,1142,3294,41,41,2152,0.22630111524163568,1665
579,1758929356558856162,1758929356595784984,36.929,467,491,1900,838,2738,33,33,1900,0.25842105263157894,1409
580,1758929956766339991,1758929956868466407,102.126,467,491,1900,838,2738,33,33,1900,0.25842105263157894,1409
581,1758930555978006440,1758930556219072534,241.066,467,491,1900,838,2738,33,33,1900,0.25842105263157894,1409
582,1758931156195386335,1758931156491341279,295.955,467,491,1900,838,2738,33,33,1900,0.25842105263157894,1409
583,1758931756395693702,1758931756454997890,59.304,467,491,1900,838,2738,33,33,1900,0.25842105263157894,1409
584,1758932356586083751,1758932356723691827,137.608,463,487,1896,838,2734,33,33,1896,0.2568565400843882,1409
585,1758932956769554759,1758932956997307771,227.753,463,487,1896,838,2734,33,33,1896,0.2568565400843882,1409
586,1758933555964579865,1758933556040429566,75.85,463,487,1896,838,2734,33,33,1896,0.2568565400843882,1409
587,1758934156178803352,1758934156310739659,131.936,459,483,1892,838,2730,33,33,1892,0.25528541226215645,1409
588,1758934756391500505,1758934756581759559,190.259,463,487,1896,838,2734,33,33,1896,0.2568565400843882,1409
589,1758935356600400044,1758935356852479838,252.08,463,487,1896,838,2734,33,33,1896,0.2568565400843882,1409
590,1758935956806832861,1758935957123959338,317.126,463,487,1896,838,2734,33,33,1896,0.2568565400843882,1409
591,1758936556014728335,1758936556027996757,13.268,463,487,1896,838,2734,33,33,1896,0.2568565400843882,1409
592,1758937156231391389,1758937156435757576,204.366,459,483,1892,838,2730,33,33,1892,0.25528541226215645,1409
593,1758937756434701916,1758937756709289475,274.588,463,487,2048,1018,3066,38,38,2048,0.23779296875,1561
594,1758938356633205539,1758938356646708191,13.503,463,487,1920,942,2862,35,35,1920,0.25364583333333335,1433
595,1758938956814905735,1758938957140755488,325.85,463,487,1896,838,2734,33,33,1896,0.2568565400843882,1409
596,1758939556021428031,1758939556085913361,64.485,463,487,2124,1082,3206,40,40,2124,0.2292843691148776,1637
597,1758940156236267729,1758940156549568404,313.301,459,483,1892,838,2730,33,33,1892,0.25528541226215645,1409
598,1758940756443501006,1758940756683807576,240.307,463,487,1896,838,2734,33,33,1896,0.2568565400843882,1409
599,1758941356637621773,1758941356912765675,275.144,459,483,1892,838,2730,33,33,1892,0.25528541226215645,1409
600,1758941956830865956,1758941956878894310,48.028,463,487,2276,1210,3486,44,44,2276,0.2139718804920914,1789
601,1758942556036057280,1758942556359614839,323.558,463,487,1896,838,2734,33,33,1896,0.2568565400843882,1409
602,1758943156250043567,1758943156415438275,165.395,463,487,2124,1018,3142,39,39,2124,0.2292843691148776,1637
603,1758943756456449134,1758943756732073428,275.624,463,487,1896,838,2734,33,33,1896,0.2568565400843882,1409
604,1758944356660197675,1758944356812131532,151.934,463,487,1896,838,2734,33,33,1896,0.2568565400843882,1409
605,1758944956858436083,1758944957172434934,313.999,463,487,1896,838,2734,33,33,1896,0.2568565400843882,1409
606,1758945556066046985,1758945556197794091,131.747,463,487,2048,1018,3066,38,38,2048,0.23779296875,1561
607,1758946156256900527,1758946156361536917,104.636,463,487,1896,838,2734,33,33,1896,0.2568565400843882,1409
608,1758946756459586003,1758946756749257984,289.672,463,487,2124,1082,3206,40,40,2124,0.2292843691148776,1637
609,1758947356660969691,1758947356882591035,221.621,463,487,1896,838,2734,33,33,1896,0.2568565400843882,1409
610,1758947956851868469,1758947957050797139,198.929,463,487,2124,1030,3154,39,39,2124,0.2292843691148776,1637
611,1758948556036633644,1758948556322286407,285.653,463,487,1896,838,2734,33,33,1896,0.2568565400843882,1409
612,1758949156247397362,1758949156508143380,260.746,463,487,1896,838,2734,33,33,1896,0.2568565400843882,1409
613,1758949756455200643,1758949756629753950,174.553,463,487,1896,838,2734,33,33,1896,0.2568565400843882,1409
614,1758950356649994170,1758950356916963176,266.969,463,487,1896,838,2734,33,33,1896,0.2568565400843882,1409
615,1758950955842930353,1758950955981921124,138.991,463,487,1896,838,2734,33,33,1896,0.2568565400843882,1409
616,1758951556055796245,1758951556158742285,102.946,463,487,1896,838,2734,33,33,1896,0.2568565400843882,1409
617,1758952156250759605,1758952156357728784,106.969,463,487,1896,838,2734,33,33,1896,0.2568565400843882,1409
618,1758952756458429973,1758952756471459701,13.03,463,487,1768,762,2530,30,30,1768,0.2754524886877828,1281
619,1758953356663848661,1758953356847612354,183.764,463,487,1844,838,2682,32,32,1844,0.26409978308026033,1357
620,1758953955858228295,1758953956024077555,165.849,463,487,2124,1082,3206,40,40,2124,0.2292843691148776,1637
621,1758954556064144948,1758954556245025423,180.88,463,487,1896,838,2734,33,33,1896,0.2568565400843882,1409
622,1758955156273249654,1758955156449651250,176.402,463,487,1896,838,2734,33,33,1896,0.2568565400843882,1409
623,1758955756482679475,1758955756541111210,58.432,459,483,1892,838,2730,33,33,1892,0.25528541226215645,1409
624,1758956356683270927,1758956356778746668,95.476,459,483,1892,838,2730,33,33,1892,0.25528541226215645,1409
625,1758956956877229513,1758956957044824642,167.595,463,487,1896,838,2734,33,33,1896,0.2568565400843882,1409
626,1758957556092680992,1758957556317746529,225.066,459,483,2044,1018,3062,38,38,2044,0.2363013698630137,1561
627,1758958156276010974,1758958156324101151,48.09,459,483,2044,966,3010,37,37,2044,0.2363013698630137,1561
628,1758958756483402929,1758958756524450740,41.048,463,487,1896,838,2734,33,33,1896,0.2568565400843882,1409
629,1758959356681142779,1758959356901136568,219.994,463,487,1896,838,2734,33,33,1896,0.2568565400843882,1409
630,1758959956874635945,1758959957149293606,274.658,463,487,1896,838,2734,33,33,1896,0.2568565400843882,1409
631,1758960556084860513,1758960556382752579,297.892,463,487,1896,838,2734,33,33,1896,0.2568565400843882,1409
632,1758961156270386761,1758961156394662232,124.275,463,487,1896,838,2734,33,33,1896,0.2568565400843882,1409
633,1758961756476431061,1758961756562192596,85.762,463,487,1896,838,2734,33,33,1896,0.2568565400843882,1409
634,1758962356673471977,1758962356698142923,24.671,463,487,1896,838,2734,33,33,1896,0.2568565400843882,1409
635,1758962956863957718,1758962957079640665,215.683,463,487,1896,838,2734,33,33,1896,0.2568565400843882,1409
636,1758963556051260324,1758963556343947719,292.687,459,483,1892,838,2730,33,33,1892,0.25528541226215645,1409
637,1758964156262202064,1758964156313814277,51.612,463,487,1896,838,2734,33,33,1896,0.2568565400843882,1409
638,1758964756471213020,1758964756761178743,289.966,463,487,2124,1082,3206,40,40,2124,0.2292843691148776,1637
639,1758965356673794042,1758965356699009817,25.216,459,483,1892,838,2730,33,33,1892,0.25528541226215645,1409
640,1758965955873602600,1758965956075574345,201.972,459,483,2044,1018,3062,38,38,2044,0.2363013698630137,1561
641,1758966556090387811,1758966556103711154,13.323,459,483,1892,838,2730,33,33,1892,0.25528541226215645,1409
642,1758967156288731756,1758967156514654802,225.923,463,487,2124,1082,3206,40,40,2124,0.2292843691148776,1637
643,1758967756473899059,1758967756487108472,13.209,463,487,1844,826,2670,32,32,1844,0.26409978308026033,1357
644,1758968356676304753,1758968356762469272,86.165,463,487,1972,902,2874,35,35,1972,0.24695740365111563,1485
645,1758968956877837775,1758968957134929012,257.091,463,487,1896,838,2734,33,33,1896,0.2568565400843882,1409
646,1758969556101377094,1758969556129573946,28.197,463,487,1896,838,2734,33,33,1896,0.2568565400843882,1409
647,1758970156315762785,1758970156349245722,33.483,463,487,1896,838,2734,33,33,1896,0.2568565400843882,1409
648,1758970756516620097,1758970756635529812,118.91,463,487,1896,838,2734,33,33,1896,0.2568565400843882,1409
649,1758971356705247833,1758971357000135146,294.887,463,487,1896,838,2734,33,33,1896,0.2568565400843882,1409
650,1758971955913145356,1758971956121643609,208.498,463,487,1896,838,2734,33,33,1896,0.2568565400843882,1409
651,1758972556133919135,1758972556280767595,146.848,463,487,1896,838,2734,33,33,1896,0.2568565400843882,1409
652,1758973156351915996,1758973156607542710,255.627,463,487,1896,838,2734,33,33,1896,0.2568565400843882,1409
653,1758973756548645072,1758973756846329704,297.685,463,487,2048,966,3014,37,37,2048,0.23779296875,1561
654,1758974356733667909,1758974356814661720,80.994,463,487,1896,838,2734,33,33,1896,0.2568565400843882,1409
655,1758974955941265425,1758974956088401054,147.136,467,491,1976,902,2878,35,35,1976,0.24848178137651822,1485
656,1758975556158595481,1758975556212064241,53.469,467,491,2128,1030,3158,39,39,2128,0.23073308270676693,1637
657,1758976156355478184,1758976156649139965,293.662,459,483,1892,838,2730,33,33,1892,0.25528541226215645,1409
658,1758976756561896699,1758976756691981274,130.085,463,487,1896,838,2734,33,33,1896,0.2568565400843882,1409
659,1758977356760441543,1758977356781518625,21.077,459,483,1892,838,2730,33,33,1892,0.25528541226215645,1409
660,1758977955970874013,1758977956094281694,123.408,463,487,1896,838,2734,33,33,1896,0.2568565400843882,1409
661,1758978556188282024,1758978556220091465,31.809,463,487,1896,838,2734,33,33,1896,0.2568565400843882,1409
662,1758979156399367135,1758979156518352830,118.986,463,487,1896,838,2734,33,33,1896,0.2568565400843882,1409
663,1758979756593986024,1758979756910153183,316.167,463,487,1896,838,2734,33,33,1896,0.2568565400843882,1409
664,1758980355781140391,1758980356013349984,232.21,463,487,1896,838,2734,33,33,1896,0.2568565400843882,1409
665,1758980956976915593,1758980957009436195,32.521,463,487,1896,838,2734,33,33,1896,0.2568565400843882,1409
666,1758981556187715327,1758981556363743490,176.028,463,487,1896,838,2734,33,33,1896,0.2568565400843882,1409
667,1758982156377378273,1758982156392138176,14.76,463,487,1768,762,2530,30,30,1768,0.2754524886877828,1281
668,1758982756586269811,1758982756856844420,270.575,463,487,1896,838,2734,33,33,1896,0.2568565400843882,1409
669,1758983356789603839,1758983356820382301,30.778,467,491,1900,838,2738,33,33,1900,0.25842105263157894,1409
670,1758983956999864426,1758983957179769494,179.905,467,491,1900,838,2738,33,33,1900,0.25842105263157894,1409
671,1758984556218832455,1758984556529553727,310.721,467,491,1900,838,2738,33,33,1900,0.25842105263157894,1409
672,1758985156417912250,1758985156493493754,75.582,467,491,2052,1018,3070,38,38,2052,0.23927875243664717,1561
673,1758985756610937276,1758985756818440802,207.504,467,491,1900,838,2738,33,33,1900,0.25842105263157894,1409
674,1758986356788756517,1758986356867832354,79.076,463,487,1896,838,2734,33,33,1896,0.2568565400843882,1409
675,1758986956998032978,1758986957110066841,112.034,467,491,1900,838,2738,33,33,1900,0.25842105263157894,1409
676,1758987556210893196,1758987556516788467,305.895,467,491,1900,838,2738,33,33,1900,0.25842105263157894,1409
677,1758988156406689857,1758988156516573383,109.884,463,487,1896,838,2734,33,33,1896,0.2568565400843882,1409
678,1758988756598644864,1758988756746663455,148.019,459,483,1892,838,2730,33,33,1892,0.25528541226215645,1409
679,1758989356781572376,1758989357017166433,235.594,463,487,1896,838,2734,33,33,1896,0.2568565400843882,1409
680,1758989955987807970,1758989956059603384,71.795,463,487,1896,838,2734,33,33,1896,0.2568565400843882,1409
681,1758990556200656339,1758990556330790978,130.135,459,483,1892,838,2730,33,33,1892,0.25528541226215645,1409
682,1758991156409434357,1758991156602248347,192.814,463,487,1896,838,2734,33,33,1896,0.2568565400843882,1409
683,1758991756615370665,1758991756874084208,258.714,463,487,1896,838,2734,33,33,1896,0.2568565400843882,1409
684,1758992356813599130,1758992356837630037,24.031,459,483,1892,838,2730,33,33,1892,0.25528541226215645,1409
685,1758992956021865745,1758992956186603196,164.737,463,487,1896,838,2734,33,33,1896,0.2568565400843882,1409
686,1758993556233179431,1758993556457513854,224.334,463,487,1896,838,2734,33,33,1896,0.2568565400843882,1409
687,1758994156436753733,1758994156729072690,292.319,459,483,1892,838,2730,33,33,1892,0.25528541226215645,1409
688,1758994756630379685,1758994756692932245,62.553,463,487,1896,838,2734,33,33,1896,0.2568565400843882,1409
689,1758995355818140087,1758995356042540291,224.4,463,487,1896,838,2734,33,33,1896,0.2568565400843882,1409
690,1758995956008945284,1758995956022218901,13.274,463,487,1896,838,2734,33,33,1896,0.2568565400843882,1409
691,1758996556203266397,1758996556277832390,74.566,459,483,1892,838,2730,33,33,1892,0.25528541226215645,1409
692,1758997156408133429,1758997156420935409,12.802,463,487,1896,838,2734,33,33,1896,0.2568565400843882,1409
693,1758997756616119243,1758997756628406636,12.287,463,487,1768,762,2530,30,30,1768,0.2754524886877828,1281
694,1758998356818616056,1758998357090002057,271.386,459,483,1892,838,2730,33,33,1892,0.25528541226215645,1409
695,1758998956030619288,1758998956132874716,102.255,459,483,1892,838,2730,33,33,1892,0.25528541226215645,1409
696,1758999556244080084,1758999556403938470,159.858,463,487,1896,838,2734,33,33,1896,0.2568565400843882,1409
697,1759000156447200338,1759000156674718107,227.518,459,483,1892,838,2730,33,33,1892,0.25528541226215645,1409
698,1759000756640873238,1759000756946118344,305.245,463,487,1896,838,2734,33,33,1896,0.2568565400843882,1409
699,1759001356828933474,1759001356909164871,80.231,463,487,1896,838,2734,33,33,1896,0.2568565400843882,1409
700,1759001957031457595,1759001957180876724,149.419,459,483,1892,838,2730,33,33,1892,0.25528541226215645,1409
701,1759002556220195751,1759002556530416010,310.22,463,487,1896,838,2734,33,33,1896,0.2568565400843882,1409
702,1759003156417064226,1759003156495025599,77.961,463,487,1896,838,2734,33,33,1896,0.2568565400843882,1409
703,1759003756621984739,1759003756766175313,144.191,459,483,1892,838,2730,33,33,1892,0.25528541226215645,1409
704,1759004356822161363,1759004357037256775,215.095,463,487,1896,838,2734,33,33,1896,0.2568565400843882,1409
705,1759004956031709338,1759004956079507798,47.798,463,487,1896,838,2734,33,33,1896,0.2568565400843882,1409
706,1759005556247387981,1759005556350721362,103.333,463,487,1896,838,2734,33,33,1896,0.2568565400843882,1409
707,1759006156457405569,1759006156622057808,164.652,463,487,1896,838,2734,33,33,1896,0.2568565400843882,1409
708,1759006756653154175,1759006756893271031,240.117,463,487,1896,838,2734,33,33,1896,0.2568565400843882,1409
709,1759007356840054044,1759007357163851725,323.798,463,487,1896,838,2734,33,33,1896,0.2568565400843882,1409
710,1759007956047816778,1759007956206741322,158.925,459,483,1892,838,2730,33,33,1892,0.25528541226215645,1409
711,1759008556239850838,1759008556477167829,237.317,463,487,1896,838,2734,33,33,1896,0.2568565400843882,1409
712,1759009156421517456,1759009156748077916,326.56,463,487,1896,838,2734,33,33,1896,0.2568565400843882,1409
713,1759009756626426789,1759009756712316767,85.89,463,487,1896,838,2734,33,33,1896,0.2568565400843882,1409
714,1759010355827845301,1759010356061141933,233.297,459,483,1892,838,2730,33,33,1892,0.25528541226215645,1409
715,1759010956037327782,1759010956332645072,295.317,459,483,1892,838,2730,33,33,1892,0.25528541226215645,1409
716,1759011556252139474,1759011556266521551,14.382,463,487,1896,838,2734,33,33,1896,0.2568565400843882,1409
717,1759012156460082311,1759012156525769614,65.687,463,487,1896,838,2734,33,33,1896,0.2568565400843882,1409
718,1759012756658094859,1759012756839157582,181.063,463,487,1896,838,2734,33,33,1896,0.2568565400843882,1409
719,1759013356849804762,1759013356863678302,13.874,463,487,1768,762,2530,30,30,1768,0.2754524886877828,1281
720,1759013956057770133,1759013956152115418,94.345,463,487,1896,838,2734,33,33,1896,0.2568565400843882,1409
721,1759014556258555086,1759014556423822506,165.267,463,487,1896,838,2734,33,33,1896,0.2568565400843882,1409
722,1759015156444801701,1759015156694481614,249.68,463,487,1896,838,2734,33,33,1896,0.2568565400843882,1409
723,1759015756625856271,1759015756659041857,33.186,463,487,1896,838,2734,33,33,1896,0.2568565400843882,1409
724,1759016356827959956,1759016356929720987,101.761,463,487,1896,838,2734,33,33,1896,0.2568565400843882,1409
725,1759016956041812512,1759016956278367368,236.555,463,487,1896,838,2734,33,33,1896,0.2568565400843882,1409
726,1759017556255377485,1759017556549549693,294.172,459,483,1892,838,2730,33,33,1892,0.25528541226215645,1409
727,1759018156465449111,1759018156513197783,47.749,463,487,1896,838,2734,33,33,1896,0.2568565400843882,1409
728,1759018756664658088,1759018756785071238,120.413,463,487,1896,838,2734,33,33,1896,0.2568565400843882,1409
729,1759019356861682689,1759019357055902341,194.22,463,487,1896,838,2734,33,33,1896,0.2568565400843882,1409
730,1759019956071873204,1759019956098574799,26.702,463,487,1896,838,2734,33,33,1896,0.2568565400843882,1409
731,1759020556276675076,1759020556373322413,96.647,463,487,1896,838,2734,33,33,1896,0.2568565400843882,1409
732,1759021156465545580,1759021156641287364,175.742,463,487,1896,838,2734,33,33,1896,0.2568565400843882,1409
733,1759021756649239430,1759021756911888754,262.649,459,483,1892,838,2730,33,33,1892,0.25528541226215645,1409
734,1759022356854111677,1759022356875638702,21.527,463,487,2048,1018,3066,38,38,2048,0.23779296875,1561
735,1759022956064849900,1759022956126438053,61.588,459,483,1892,838,2730,33,33,1892,0.25528541226215645,1409
736,1759023556276593167,1759023556397729762,121.137,463,487,1896,838,2734,33,33,1896,0.2568565400843882,1409
737,1759024156480883315,1759024156558767345,77.884,463,487,2124,1018,3142,39,39,2124,0.2292843691148776,1637
738,1759024756668714072,1759024756681666023,12.952,463,487,2124,1030,3154,39,39,2124,0.2292843691148776,1637
739,1759025356872204750,1759025357020290227,148.085,463,487,1972,902,2874,35,35,1972,0.24695740365111563,1485
740,1759025958089804974,1759025958413641347,323.836,463,487,1972,902,2874,35,35,1972,0.24695740365111563,1485
741,1759026556299739802,1759026556507514603,207.775,463,487,2124,1082,3206,40,40,2124,0.2292843691148776,1637
742,1759027158507514918,1759027158521217354,13.702,463,487,1896,838,2734,33,33,1896,0.2568565400843882,1409
743,1759027756708692637,1759027756722118134,13.425,463,487,1920,942,2862,35,35,1920,0.25364583333333335,1433
744,1759028357903619081,1759028357921365619,17.747,459,483,2144,1146,3290,41,41,2144,0.22527985074626866,1661
745,1759028956100422773,1759028956377717729,277.295,463,487,1896,890,2786,34,34,1896,0.2568565400843882,1409
746,1759029556308992909,1759029556349193363,40.2,463,487,2048,966,3014,37,37,2048,0.23779296875,1561
747,1759030156516798620,1759030158554329739,2037.531,459,483,2528,966,3494,37,37,2528,0.19106012658227847,2045
748,1759030758719301709,1759030758945694296,226.393,459,483,1968,902,2870,35,35,1968,0.24542682926829268,1485
749,1759031356918078818,1759031357160960889,242.882,463,487,1896,838,2734,33,33,1896,0.2568565400843882,1409
750,1759031956130827625,1759031956261438553,130.611,459,483,1892,838,2730,33,33,1892,0.25528541226215645,1409
751,1759032556327457762,1759032556532635201,205.177,459,483,1892,838,2730,33,33,1892,0.25528541226215645,1409
752,1759033156513215200,1759033156803851895,290.637,463,487,1896,838,2734,33,33,1896,0.2568565400843882,1409
753,1759033756692065980,1759033756767319320,75.253,463,487,1896,838,2734,33,33,1896,0.2568565400843882,1409
754,1759034355890770317,1759034356117451176,226.681,463,487,1896,838,2734,33,33,1896,0.2568565400843882,1409
755,1759034956106080220,1759034956388378024,282.298,459,483,1892,838,2730,33,33,1892,0.25528541226215645,1409
756,1759035556315942183,1759035556352082358,36.14,459,483,1892,838,2730,33,33,1892,0.25528541226215645,1409
757,1759036156523623798,1759036156623423885,99.8,463,487,1896,838,2734,33,33,1896,0.2568565400843882,1409
758,1759036756720165645,1759036756894584608,174.419,459,483,1892,838,2730,33,33,1892,0.25528541226215645,1409
759,1759037356919236351,1759037357164899042,245.663,459,483,1892,838,2730,33,33,1892,0.25528541226215645,1409
760,1759037956133999292,1759037956207036998,73.038,463,487,1896,838,2734,33,33,1896,0.2568565400843882,1409
761,1759038556341149152,1759038556478790135,137.641,463,487,1896,838,2734,33,33,1896,0.2568565400843882,1409
762,1759039156534394212,1759039156749689372,215.295,463,487,1896,838,2734,33,33,1896,0.2568565400843882,1409
763,1759039756717489317,1759039757020770764,303.281,463,487,1896,838,2734,33,33,1896,0.2568565400843882,1409
764,1759040355900595061,1759040356062925608,162.331,463,487,1896,838,2734,33,33,1896,0.2568565400843882,1409
765,1759040956116913951,1759040956129879041,12.965,463,487,1896,838,2734,33,33,1896,0.2568565400843882,1409
766,1759041556329779680,1759041556605634458,275.855,459,483,1892,838,2730,33,33,1892,0.25528541226215645,1409
767,1759042156538223673,1759042156552020183,13.797,463,487,2072,1018,3090,38,38,2072,0.23503861003861004,1585
768,1759042756735814655,1759042756934511718,198.697,463,487,1920,902,2822,34,34,1920,0.25364583333333335,1433
769,1759043355925108256,1759043356102290718,177.182,459,483,1968,902,2870,35,35,1968,0.24542682926829268,1485
770,1759043958128607108,1759043958329803447,201.196,463,487,2124,954,3078,38,38,2124,0.2292843691148776,1637
771,1759044556306976267,1759044556451713264,144.737,463,487,2048,966,3014,37,37,2048,0.23779296875,1561
772,1759045156514528648,1759045156833298081,318.769,459,483,1968,902,2870,35,35,1968,0.24542682926829268,1485
773,1759045756716216993,1759045756956096951,239.88,463,487,2048,966,3014,37,37,2048,0.23779296875,1561
774,1759046358915398267,1759046359158707597,243.309,463,487,2048,966,3014,37,37,2048,0.23779296875,1561
775,1759046956123212896,1759046956264469120,141.256,463,487,1896,890,2786,34,34,1896,0.2568565400843882,1409
776,1759047556300978665,1759047556525408034,224.429,459,483,2120,1082,3202,40,40,2120,0.2278301886792453,1637
777,1759048156507699126,1759048156704663007,196.964,463,487,2124,1082,3206,40,40,2124,0.2292843691148776,1637
778,1759048756713927530,1759048756852011145,138.084,463,487,2048,966,3014,37,37,2048,0.23779296875,1561
779,1759049356911908770,1759049357053556872,141.648,459,483,1892,838,2730,33,33,1892,0.25528541226215645,1409
780,1759049956131076269,1759049956311395418,180.319,459,483,1892,838,2730,33,33,1892,0.25528541226215645,1409
781,1759050556338306645,1759050556634071009,295.764,459,483,2044,1018,3062,38,38,2044,0.2363013698630137,1561
782,1759051156532211298,1759051156634842509,102.631,463,487,1972,902,2874,35,35,1972,0.24695740365111563,1485
783,1759051756722180624,1759051757027915754,305.735,459,483,2120,1082,3202,40,40,2120,0.2278301886792453,1637
784,1759052355908663388,1759052355921101090,12.438,463,487,1896,838,2734,33,33,1896,0.2568565400843882,1409
785,1759052957105174424,1759052957118125073,12.951,459,483,1892,838,2730,33,33,1892,0.25528541226215645,1409
786,1759053556315789477,1759053556328735153,12.946,463,487,2072,1070,3142,39,39,2072,0.23503861003861004,1585
787,1759054156521238111,1759054156545920358,24.682,459,483,2044,966,3010,37,37,2044,0.2363013698630137,1561
788,1759054756709790138,1759054756842098217,132.308,459,483,1892,838,2730,33,33,1892,0.25528541226215645,1409
789,1759055355895357312,1759055356095396940,200.04,463,487,2200,1094,3294,41,41,2200,0.22136363636363637,1713
790,1759055956111670829,1759055956353893020,242.222,463,487,2124,1030,3154,39,39,2124,0.2292843691148776,1637
791,1759056556321838640,1759056556577270629,255.432,459,483,1892,838,2730,33,33,1892,0.25528541226215645,1409
792,1759057157519810486,1759057157613438318,93.628,463,487,2048,1018,3066,38,38,2048,0.23779296875,1561
793,1759057756704966465,1759057756937006167,232.04,463,487,2048,966,3014,37,37,2048,0.23779296875,1561
794,1759058356909498256,1759058356939954281,30.456,463,487,2048,966,3014,37,37,2048,0.23779296875,1561
795,1759058956128880620,1759058956324637919,195.757,459,483,1968,902,2870,35,35,1968,0.24542682926829268,1485
796,1759059556343804000,1759059556480917310,137.113,463,487,2048,1018,3066,38,38,2048,0.23779296875,1561
797,1759060156546164481,1759060156690619174,144.455,463,487,2380,1334,3714,47,47,2380,0.2046218487394958,1893
798,1759060756733325345,1759060756899924987,166.6,463,487,2048,1018,3066,38,38,2048,0.23779296875,1561
799,1759061357936903794,1759061358113443315,176.54,463,487,1896,838,2734,33,33,1896,0.2568565400843882,1409
800,1759061956154722306,1759061956478516387,323.794,463,487,2048,966,3014,37,37,2048,0.23779296875,1561
801,1759062558362202175,1759062558634975803,272.774,463,487,2048,966,3014,37,37,2048,0.23779296875,1561
802,1759063157568345048,1759063157582843629,14.499,463,487,1896,838,2734,33,33,1896,0.2568565400843882,1409
803,1759063756765471002,1759063756969413235,203.942,459,483,2120,1082,3202,40,40,2120,0.2278301886792453,1637
804,1759064356968971483,1759064356981920278,12.949,459,483,1764,762,2526,30,30,1764,0.27380952380952384,1281
805,1759064956179244502,1759064956321191260,141.947,463,487,2124,1030,3154,39,39,2124,0.2292843691148776,1637
806,1759065556366921915,1759065556396378088,29.456,463,487,1972,902,2874,35,35,1972,0.24695740365111563,1485
807,1759066156573279165,1759066156628164158,54.885,463,487,2200,1146,3346,42,42,2200,0.22136363636363637,1713
808,1759066756773288739,1759066757088732578,315.444,459,483,2044,966,3010,37,37,2044,0.2363013698630137,1561
809,1759067355971987695,1759067356087995878,116.008,463,487,2200,1094,3294,41,41,2200,0.22136363636363637,1713
810,1759067956174184726,1759067956459430971,285.246,463,487,1972,902,2874,35,35,1972,0.24695740365111563,1485
811,1759068556383710707,1759068556603811355,220.101,463,487,1896,838,2734,33,33,1896,0.2568565400843882,1409
812,1759069156591289021,1759069156701401542,110.113,463,487,2048,1018,3066,38,38,2048,0.23779296875,1561
813,1759069756790300649,1759069756872510122,82.209,459,483,1892,838,2730,33,33,1892,0.25528541226215645,1409
814,1759070356992812402,1759070357269255352,276.443,459,483,1968,954,2922,36,36,1968,0.24542682926829268,1485
815,1759070956193934217,1759070956280881813,86.948,463,487,1896,838,2734,33,33,1896,0.2568565400843882,1409
816,1759071556375269678,1759071556576375821,201.106,459,483,1892,838,2730,33,33,1892,0.25528541226215645,1409
817,1759072156554559809,1759072156757228980,202.669,463,487,2200,1082,3282,41,41,2200,0.22136363636363637,1713
818,1759072756757322945,1759072756815105986,57.783,463,487,1896,890,2786,34,34,1896,0.2568565400843882,1409
819,1759073356963813834,1759073357159963515,196.15,463,487,2048,966,3014,37,37,2048,0.23779296875,1561
820,1759073956178972344,1759073956374834793,195.862,463,487,1896,838,2734,33,33,1896,0.2568565400843882,1409
821,1759074558392395923,1759074558405710212,13.314,463,487,1972,902,2874,35,35,1972,0.24695740365111563,1485
822,1759075156579691127,1759075156688657664,108.967,459,483,1992,954,2946,36,36,1992,0.24246987951807228,1509
823,1759075756758923867,1759075756825097725,66.174,463,487,1896,838,2734,33,33,1896,0.2568565400843882,1409
824,1759076355962846760,1759076356127365424,164.519,463,487,1896,838,2734,33,33,1896,0.2568565400843882,1409
825,1759076956178829334,1759076956377385586,198.556,463,487,1896,838,2734,33,33,1896,0.2568565400843882,1409
826,1759077556389761927,1759077556648841626,259.08,463,487,1896,838,2734,33,33,1896,0.2568565400843882,1409
827,1759078156582723802,1759078156611926972,29.203,463,487,1896,838,2734,33,33,1896,0.2568565400843882,1409
828,1759078756772266462,1759078756874053461,101.787,463,487,2276,1262,3538,45,45,2276,0.2139718804920914,1789
829,1759079358965880529,1759079359037417543,71.537,463,487,1972,902,2874,35,35,1972,0.24695740365111563,1485
830,1759079956178425856,1759079956396399832,217.974,463,487,1896,838,2734,33,33,1896,0.2568565400843882,1409
831,1759080556385597748,1759080556667407660,281.81,463,487,1896,838,2734,33,33,1896,0.2568565400843882,1409
832,1759081156591464943,1759081156630877015,39.412,463,487,1896,838,2734,33,33,1896,0.2568565400843882,1409
833,1759081756786220251,1759081756956398154,170.178,459,483,2148,1142,3290,41,41,2148,0.22486033519553073,1665
834,1759082356993431525,1759082357252619176,259.188,463,487,1896,838,2734,33,33,1896,0.2568565400843882,1409
835,1759082956203352714,1759082956291854239,88.502,459,483,1892,838,2730,33,33,1892,0.25528541226215645,1409
836,1759083556398016332,1759083556558984291,160.968,459,483,1892,838,2730,33,33,1892,0.25528541226215645,1409
837,1759084156581489984,1759084156829741716,248.252,463,487,1972,902,2874,35,35,1972,0.24695740365111563,1485
838,1759084756761390442,1759084756790935672,29.545,463,487,1896,838,2734,33,33,1896,0.2568565400843882,1409
839,1759085355966457870,1759085356141420546,174.963,463,487,1896,838,2734,33,33,1896,0.2568565400843882,1409
840,1759085956181323776,1759085956501653077,320.329,463,487,1896,838,2734,33,33,1896,0.2568565400843882,1409
841,1759086556387845514,1759086556465688298,77.843,463,487,1896,838,2734,33,33,1896,0.2568565400843882,1409
842,1759087156595680733,1759087156737117208,141.436,463,487,1896,838,2734,33,33,1896,0.2568565400843882,1409
843,1759087755792210711,1759087755885374616,93.164,459,483,1892,838,2730,33,33,1892,0.25528541226215645,1409
844,1759088356995362734,1759088357279177309,283.815,463,487,1896,838,2734,33,33,1896,0.2568565400843882,1409
845,1759088956205343241,1759088956218165417,12.822,463,487,1768,762,2530,30,30,1768,0.2754524886877828,1281
846,1759089556392916201,1759089556592522203,199.606,459,483,1892,838,2730,33,33,1892,0.25528541226215645,1409
847,1759090156577530611,1759090156863227903,285.697,459,483,1892,838,2730,33,33,1892,0.25528541226215645,1409
848,1759090756752393552,1759090756827785380,75.392,459,483,1892,838,2730,33,33,1892,0.25528541226215645,1409
849,1759091355955630060,1759091356176391833,220.762,463,487,1896,838,2734,33,33,1896,0.2568565400843882,1409
850,1759091956173942053,1759091956448114629,274.173,463,487,1896,838,2734,33,33,1896,0.2568565400843882,1409
851,1759092556385384178,1759092556515196900,129.813,459,483,1892,838,2730,33,33,1892,0.25528541226215645,1409
852,1759093156581331755,1759093156791550212,210.218,463,487,1896,838,2734,33,33,1896,0.2568565400843882,1409
853,1759093756777008650,1759093756848399538,71.391,463,487,1896,838,2734,33,33,1896,0.2568565400843882,1409
854,1759094355973852000,1759094356198008263,224.156,463,487,1896,838,2734,33,33,1896,0.2568565400843882,1409
855,1759094956174772888,1759094956330764510,155.992,463,487,2200,1094,3294,41,41,2200,0.22136363636363637,1713
856,1759095556385976553,1759095556438395313,52.419,459,483,2044,966,3010,37,37,2044,0.2363013698630137,1561
857,1759096156594181931,1759096156811097048,216.915,463,487,2124,1030,3154,39,39,2124,0.2292843691148776,1637
858,1759096756795219515,1759096756960131720,164.912,463,487,2276,1210,3486,44,44,2276,0.2139718804920914,1789
859,1759097356003880418,1759097356151584051,147.704,463,487,1896,838,2734,33,33,1896,0.2568565400843882,1409
860,1759097956216287599,1759097956494356078,278.068,463,487,2200,1146,3346,42,42,2200,0.22136363636363637,1713
861,1759098556407197024,1759098556633574405,226.377,463,487,1896,838,2734,33,33,1896,0.2568565400843882,1409
862,1759099156586516470,1759099156709442283,122.926,463,487,2228,1206,3434,43,43,2228,0.21858168761220825,1741
863,1759099756788385931,1759099756883180435,94.795,463,487,1896,838,2734,33,33,1896,0.2568565400843882,1409
864,1759100358995129202,1759100359309320672,314.191,463,487,2124,1134,3258,41,41,2124,0.2292843691148776,1637
865,1759100956210840128,1759100956222827072,11.987,459,483,1968,902,2870,35,35,1968,0.24542682926829268,1485
866,1759101556421340552,1759101556695013124,273.673,459,483,1968,902,2870,35,35,1968,0.24542682926829268,1485
867,1759102156614163789,1759102156872574179,258.41,463,487,1920,890,2810,34,34,1920,0.25364583333333335,1433
868,1759102756799751084,1759102757108345808,308.595,459,483,2044,1018,3062,38,38,2044,0.2363013698630137,1561
869,1759103357004536932,1759103357301831137,297.294,463,487,2048,1018,3066,38,38,2048,0.23779296875,1561
870,1759103956221538261,1759103956491417479,269.879,463,487,1972,902,2874,35,35,1972,0.24695740365111563,1485
871,1759104556426462560,1759104556490355491,63.893,459,483,2044,966,3010,37,37,2044,0.2363013698630137,1561
872,1759105156616295729,1759105156824746123,208.45,463,487,2048,966,3014,37,37,2048,0.23779296875,1561
873,1759105756802263659,1759105756996701734,194.438,463,487,2048,1070,3118,39,39,2048,0.23779296875,1561
874,1759106356003441912,1759106356165084313,161.642,463,487,1972,902,2874,35,35,1972,0.24695740365111563,1485
875,1759106956219253315,1759106956474687220,255.434,463,487,2048,966,3014,37,37,2048,0.23779296875,1561
876,1759107556429549516,1759107556637852467,208.303,463,487,1896,838,2734,33,33,1896,0.2568565400843882,1409
877,1759108156621612960,1759108156771928205,150.315,459,483,2196,1094,3290,41,41,2196,0.21994535519125682,1713
878,1759108756804573522,1759108756871090842,66.517,463,487,1972,902,2874,35,35,1972,0.24695740365111563,1485
879,1759109357015244575,1759109357224837840,209.593,463,487,2048,966,3014,37,37,2048,0.23779296875,1561
880,1759109956226076246,1759109956440877340,214.801,463,487,1896,838,2734,33,33,1896,0.2568565400843882,1409
881,1759110559430209841,1759110559686878352,256.669,463,487,1972,902,2874,35,35,1972,0.24695740365111563,1485
882,1759111156622886411,1759111156887513299,264.627,463,487,2048,1018,3066,38,38,2048,0.23779296875,1561
883,1759111756814670902,1759111756842167957,27.497,463,487,2048,1018,3066,38,38,2048,0.23779296875,1561
884,1759112356019746436,1759112356032906005,13.16,459,483,1892,838,2730,33,33,1892,0.25528541226215645,1409
885,1759112956226263579,1759112956368745063,142.481,463,487,2124,1082,3206,40,40,2124,0.2292843691148776,1637
886,1759113556411818350,1759113556417947516,6.129,463,487,1920,942,2862,35,35,1920,0.25364583333333335,1433
887,1759114156618741371,1759114156771212022,152.471,463,487,1896,838,2734,33,33,1896,0.2568565400843882,1409
888,1759114759817368069,1759114760089038959,271.671,463,487,1896,838,2734,33,33,1896,0.2568565400843882,1409
889,1759115356024658049,1759115356198348109,173.69,459,483,2148,1142,3290,41,41,2148,0.22486033519553073,1665
890,1759115956237028147,1759115956316107801,79.08,459,483,1892,838,2730,33,33,1892,0.25528541226215645,1409
891,1759116556448482625,1759116556744365979,295.883,463,487,2352,1222,3574,45,45,2352,0.2070578231292517,1865
892,1759117156638957762,1759117156851369960,212.412,463,487,1972,954,2926,36,36,1972,0.24695740365111563,1485
893,1759117756821849491,1759117757052112625,230.263,463,487,2048,966,3014,37,37,2048,0.23779296875,1561
894,1759118357007547319,1759118358204484187,1196.937,463,487,2536,966,3502,37,37,2536,0.1920347003154574,2049
895,1759118956218037783,1759118956243156950,25.119,463,487,2352,1326,3678,47,47,2352,0.2070578231292517,1865
896,1759119556426030005,1759119556648042275,222.012,463,487,2048,966,3014,37,37,2048,0.23779296875,1561
897,1759120156619823521,1759120156794835567,175.012,463,487,2048,1018,3066,38,38,2048,0.23779296875,1561
898,1759120758800540574,1759120759034003614,233.463,459,483,2044,966,3010,37,37,2044,0.2363013698630137,1561
899,1759121357007823774,1759121357209213283,201.39,463,487,2048,902,2950,36,36,2048,0.23779296875,1561
900,1759121956221016771,1759121956503666542,282.65,459,483,1968,902,2870,35,35,1968,0.24542682926829268,1485
901,1759122556424997426,1759122556622287771,197.29,463,487,1896,838,2734,33,33,1896,0.2568565400843882,1409
902,1759123156620659007,1759123156841040489,220.381,463,487,2200,1146,3346,42,42,2200,0.22136363636363637,1713
903,1759123756807160831,1759123756819889892,12.729,463,487,1896,838,2734,33,33,1896,0.2568565400843882,1409
904,1759124356003942288,1759124356016899547,12.957,459,483,1992,954,2946,36,36,1992,0.24246987951807228,1509
905,1759124956220670113,1759124956300743885,80.074,463,487,2048,1018,3066,38,38,2048,0.23779296875,1561
906,1759125556432306011,1759125556654434532,222.129,463,487,1896,838,2734,33,33,1896,0.2568565400843882,1409
907,1759126156639240124,1759126156891180731,251.941,459,483,2044,1018,3062,38,38,2044,0.2363013698630137,1561
908,1759126757836506956,1759126758083202526,246.696,459,483,2272,1158,3430,43,43,2272,0.2125880281690141,1789
909,1759127356044420039,1759127356253608720,209.189,459,483,2044,966,3010,37,37,2044,0.2363013698630137,1561
910,1759127956233640315,1759127956302260173,68.62,463,487,1972,954,2926,36,36,1972,0.24695740365111563,1485
911,1759128556441110897,1759128556747948997,306.838,463,487,1972,902,2874,35,35,1972,0.24695740365111563,1485
912,1759129156646674888,1759129156827400944,180.726,463,487,1896,838,2734,33,33,1896,0.2568565400843882,1409
913,1759129756844602697,1759129757007043645,162.441,463,487,2048,966,3014,37,37,2048,0.23779296875,1561
914,1759130357054036401,1759130357303352496,249.316,463,487,1896,838,2734,33,33,1896,0.2568565400843882,1409
915,1759130956259665900,1759130956410230495,150.565,463,487,2048,966,3014,37,37,2048,0.23779296875,1561
916,1759131556444049553,1759131556720107071,276.058,459,483,2196,1198,3394,43,43,2196,0.21994535519125682,1713
917,1759132156648564039,1759132156700559445,51.995,463,487,1896,838,2734,33,33,1896,0.2568565400843882,1409
918,1759132756850079713,1759132757163493030,313.413,463,487,2124,1030,3154,39,39,2124,0.2292843691148776,1637
919,1759133356068265581,1759133356146196487,77.931,463,487,1896,838,2734,33,33,1896,0.2568565400843882,1409
920,1759133956280173641,1759133956584855772,304.682,463,487,2200,1146,3346,42,42,2200,0.22136363636363637,1713
921,1759134556488299683,1759134556501667994,13.368,463,487,1972,954,2926,36,36,1972,0.24695740365111563,1485
922,1759135156691243317,1759135156704664967,13.422,463,487,2124,1082,3206,40,40,2124,0.2292843691148776,1637
923,1759135755898128567,1759135756206207755,308.079,463,487,1768,762,2530,30,30,1768,0.2754524886877828,1281
924,1759136356119290241,1759136356256495916,137.206,463,487,2048,966,3014,37,37,2048,0.23779296875,1561
925,1759136956330778463,1759136956522523014,191.745,463,487,1972,902,2874,35,35,1972,0.24695740365111563,1485
926,1759137556528604584,1759137556733628875,205.024,459,483,2120,1030,3150,39,39,2120,0.2278301886792453,1637
927,1759138156708478657,1759138156735539260,27.061,463,487,2200,1094,3294,41,41,2200,0.22136363636363637,1713
928,1759138756912840315,1759138757124798211,211.958,463,487,1972,902,2874,35,35,1972,0.24695740365111563,1485
929,1759139358132920679,1759139358157488483,24.568,463,487,2048,1018,3066,38,38,2048,0.23779296875,1561
930,1759139956340288812,1759139956446064176,105.775,463,487,1896,838,2734,33,33,1896,0.2568565400843882,1409
931,1759140556541593679,1759140556654511192,112.918,463,487,1896,838,2734,33,33,1896,0.2568565400843882,1409
932,1759141156727743249,1759141156833432831,105.69,463,487,1896,838,2734,33,33,1896,0.2568565400843882,1409
933,1759141755934286571,1759141756148373151,214.087,463,487,2048,966,3014,37,37,2048,0.23779296875,1561
934,1759142356151995934,1759142356180473009,28.477,459,483,1892,838,2730,33,33,1892,0.25528541226215645,1409
935,1759142959363730153,1759142959455724200,91.994,463,487,1896,838,2734,33,33,1896,0.2568565400843882,1409
936,1759143556567165532,1759143556832564263,265.399,463,487,1896,838,2734,33,33,1896,0.2568565400843882,1409
937,1759144157758891839,1759144157863752386,104.861,459,483,2120,1082,3202,40,40,2120,0.2278301886792453,1637
938,1759144758949977178,1759144759229197921,279.221,463,487,2124,966,3090,38,38,2124,0.2292843691148776,1637
939,1759145356169617967,1759145356211581040,41.963,459,483,1968,954,2922,36,36,1968,0.24542682926829268,1485
940,1759145958381364115,1759145958408507432,27.143,463,487,1896,838,2734,33,33,1896,0.2568565400843882,1409
941,1759146556584879994,1759146556623994919,39.115,459,483,1892,838,2730,33,33,1892,0.25528541226215645,1409
942,1759147156784898473,1759147156798243082,13.345,463,487,1896,838,2734,33,33,1896,0.2568565400843882,1409
943,1759147755991759913,1759147756242511100,250.751,459,483,1892,838,2730,33,33,1892,0.25528541226215645,1409
944,1759148356209335290,1759148356223054838,13.72,463,487,1768,762,2530,30,30,1768,0.2754524886877828,1281
945,1759148956405564552,1759148956684153975,278.589,459,483,1892,838,2730,33,33,1892,0.25528541226215645,1409
946,1759149556613790861,1759149556739150808,125.36,463,487,2124,1030,3154,39,39,2124,0.2292843691148776,1637
947,1759150156815792852,1759150156880194269,64.401,463,487,1896,890,2786,34,34,1896,0.2568565400843882,1409
948,1759150757032218244,1759150757316673734,284.455,463,487,1896,838,2734,33,33,1896,0.2568565400843882,1409
949,1759151356247743072,1759151356452101329,204.358,467,491,1976,902,2878,35,35,1976,0.24848178137651822,1485
950,1759151956453685724,1759151956562490681,108.805,467,491,1900,838,2738,33,33,1900,0.25842105263157894,1409
951,1759152556643571500,1759152556755399344,111.828,467,491,1976,902,2878,35,35,1976,0.24848178137651822,1485
952,1759153156834848567,1759153156983454792,148.606,467,491,2280,1210,3490,44,44,2280,0.21535087719298246,1789
953,1759153757041768938,1759153757190175693,148.407,467,491,1900,890,2790,34,34,1900,0.25842105263157894,1409
954,1759154356229182237,1759154356333809953,104.628,463,487,2048,966,3014,37,37,2048,0.23779296875,1561
955,1759154956437599747,1759154956641864540,204.265,463,487,2124,1082,3206,40,40,2124,0.2292843691148776,1637
956,1759155556643722181,1759155556895049399,251.327,467,491,2204,1146,3350,42,42,2204,0.22277676950998185,1713
957,1759156156842839349,1759156157027536590,184.697,467,491,1900,838,2738,33,33,1900,0.25842105263157894,1409
958,1759156756059625722,1759156756161184803,101.559,467,491,1900,838,2738,33,33,1900,0.25842105263157894,1409
959,1759157356274585131,1759157356359486148,84.901,467,491,2128,1082,3210,40,40,2128,0.23073308270676693,1637
960,1759157956473023321,1759157956739689851,266.667,467,491,2052,1018,3070,38,38,2052,0.23927875243664717,1561
961,1759158556665411673,1759158556703138999,37.727,463,487,1896,838,2734,33,33,1896,0.2568565400843882,1409
962,1759159156852483834,1759159157005425887,152.942,463,487,2124,1030,3154,39,39,2124,0.2292843691148776,1637
963,1759159756052126259,1759159756179466695,127.34,467,491,1900,838,2738,33,33,1900,0.25842105263157894,1409
964,1759160356264301843,1759160356278384759,14.083,463,487,1896,838,2734,33,33,1896,0.2568565400843882,1409
965,1759160956476313209,1759160956720059997,243.747,463,487,1896,838,2734,33,33,1896,0.2568565400843882,1409
966,1759161556669902642,1759161556683051164,13.149,467,491,1772,762,2534,30,30,1772,0.2770880361173815,1281
967,1759162156859614404,1759162156968691378,109.077,463,487,2048,966,3014,37,37,2048,0.23779296875,1561
968,1759162756079096849,1759162756179381763,100.285,467,491,1976,902,2878,35,35,1976,0.24848178137651822,1485
969,1759163356297881803,1759163356582422236,284.54,467,491,2128,1082,3210,40,40,2128,0.23073308270676693,1637
970,1759163956508524711,1759163956793923207,285.398,463,487,1896,838,2734,33,33,1896,0.2568565400843882,1409
971,1759164556707129340,1759164556869817753,162.688,467,491,1900,838,2738,33,33,1900,0.25842105263157894,1409
972,1759165155894350926,1759165156120531042,226.18,467,491,1900,838,2738,33,33,1900,0.25842105263157894,1409
973,1759165756113188262,1759165756176551404,63.363,467,491,1900,838,2738,33,33,1900,0.25842105263157894,1409
974,1759166356327397324,1759166356647649946,320.253,467,491,1900,838,2738,33,33,1900,0.25842105263157894,1409
975,1759166956528137328,1759166956611807177,83.67,467,491,1900,838,2738,33,33,1900,0.25842105263157894,1409
976,1759167556716666838,1759167556883921765,167.255,467,491,1900,838,2738,33,33,1900,0.25842105263157894,1409
977,1759168156901642568,1759168157154280997,252.638,463,487,1896,838,2734,33,33,1896,0.2568565400843882,1409
978,1759168756096798672,1759168756197512827,100.714,467,491,1900,838,2738,33,33,1900,0.25842105263157894,1409
979,1759169356309707796,1759169356469385522,159.678,467,491,1900,838,2738,33,33,1900,0.25842105263157894,1409
980,1759169956517841180,1759169956740270778,222.43,467,491,1900,838,2738,33,33,1900,0.25842105263157894,1409
981,1759170556726542261,1759170557012101720,285.559,467,491,1900,838,2738,33,33,1900,0.25842105263157894,1409
982,1759171156934667924,1759171156975055363,40.387,463,487,1896,838,2734,33,33,1896,0.2568565400843882,1409
983,1759171756150363790,1759171756337152495,186.789,467,491,1900,838,2738,33,33,1900,0.25842105263157894,1409
984,1759172356364383772,1759172356609005902,244.622,467,491,1900,838,2738,33,33,1900,0.25842105263157894,1409
985,1759172956568022774,1759172956880076727,312.054,463,487,1896,838,2734,33,33,1896,0.2568565400843882,1409
986,1759173556762936983,1759173556844581018,81.644,467,491,1900,838,2738,33,33,1900,0.25842105263157894,1409
987,1759174156961472658,1759174157117164746,155.692,467,491,1900,838,2738,33,33,1900,0.25842105263157894,1409
988,1759174756163434130,1759174756175948443,12.514,467,491,1900,838,2738,33,33,1900,0.25842105263157894,1409
989,1759175356354209731,1759175356430623238,76.414,467,491,1900,838,2738,33,33,1900,0.25842105263157894,1409
990,1759175956563984529,1759175956576531702,12.547,467,491,1900,838,2738,33,33,1900,0.25842105263157894,1409
991,1759176556772249326,1759176556784914850,12.666,467,491,1772,762,2534,30,30,1772,0.2770880361173815,1281
992,1759177156983191393,1759177157243829608,260.638,467,491,1900,838,2738,33,33,1900,0.25842105263157894,1409
993,1759177756200968043,1759177756286216145,85.248,467,491,1900,838,2738,33,33,1900,0.25842105263157894,1409
994,1759178356414824729,1759178356557986491,143.162,467,491,1900,838,2738,33,33,1900,0.25842105263157894,1409
995,1759178956621240620,1759178956715474145,94.234,467,491,1900,838,2738,33,33,1900,0.25842105263157894,1409
996,1759179556816185939,1759179556978353853,162.168,467,491,1900,838,2738,33,33,1900,0.25842105263157894,1409
997,1759180157021654037,1759180157321529145,299.875,467,491,1900,838,2738,33,33,1900,0.25842105263157894,1409
998,1759180756209611593,1759180756353682126,144.071,467,491,1900,838,2738,33,33,1900,0.25842105263157894,1409
999,1759181356420987312,1759181356563503101,142.516,467,491,1976,902,2878,35,35,1976,0.24848178137651822,1485
1000,1759181956629038661,1759181956906691102,277.652,468,492,1901,838,2739,33,33,1901,0.25881115202524985,1409
1001,1759182556830150219,1759182556984074079,153.924,468,492,1901,838,2739,33,33,1901,0.25881115202524985,1409
1002,1759183157049328216,1759183157285567727,236.24,468,492,1901,838,2739,33,33,1901,0.25881115202524985,1409
1003,1759183756239208909,1759183756328107621,88.899,468,492,1901,838,2739,33,33,1901,0.25881115202524985,1409
1004,1759184356451394980,1759184356655487155,204.092,468,492,1901,838,2739,33,33,1901,0.25881115202524985,1409
1005,1759184956664640023,1759184956927126721,262.487,468,492,1901,838,2739,33,33,1901,0.25881115202524985,1409
1006,1759185556874374890,1759185556906762631,32.388,468,492,1901,838,2739,33,33,1901,0.25881115202524985,1409
1007,1759186156093902894,1759186156256874152,162.971,468,492,1901,838,2739,33,33,1901,0.25881115202524985,1409
1008,1759186756314404006,1759186756526702045,212.298,468,492,621,78,699,3,3,621,0.7922705314009661,129
