msg_seq,t_tx_ns,t_rx_ns,lat_ms,payload_app,payload_envelope,wire_up_l3_bytes,wire_down_l3_bytes,wire_l3_bytes,frames_up,frames_down,msg_total_bytes_enviada,eficiencia_env,overhead_env_bytes
1,1758327555638927631,1758327555701243894,62.316,461,485,1894,838,2732,33,33,1894,0.25607180570221755,1409
2,1758328155852682889,1758328155973257988,120.575,461,485,1894,838,2732,33,33,1894,0.25607180570221755,1409
3,1758328756067188846,1758328756244466435,177.278,461,485,1894,838,2732,33,33,1894,0.25607180570221755,1409
4,1758329356278716833,1758329356608156199,329.439,461,485,1894,838,2732,33,33,1894,0.25607180570221755,1409
5,1758329956477341222,1758329956779166203,301.825,457,481,2118,1030,3148,39,39,2118,0.2271010387157696,1637
6,1758330555662282470,1758330555957865250,295.583,461,485,1894,838,2732,33,33,1894,0.25607180570221755,1409
7,1758331155866022004,1758331155911399294,45.377,461,485,1894,838,2732,33,33,1894,0.25607180570221755,1409
8,1758331756084246785,1758331756182865462,98.619,461,485,1894,838,2732,33,33,1894,0.25607180570221755,1409
9,1758332356299878128,1758332356369349138,69.471,457,481,1890,838,2728,33,33,1890,0.2544973544973545,1409
10,1758332955501881185,1758332955691738570,189.857,458,482,2043,966,3009,37,37,2043,0.2359275575134606,1561
11,1758333555695490318,1758333555863105237,167.615,458,482,2271,1198,3469,44,44,2271,0.21224130339057684,1789
12,1758334155883263781,1758334155986304986,103.041,458,482,2119,1030,3149,39,39,2119,0.22746578574799434,1637
13,1758334757104812603,1758334757126171697,21.359,458,482,2195,1094,3289,41,41,2195,0.21958997722095672,1713
14,1758335360318916252,1758335360589566058,270.65,458,482,2119,1030,3149,39,39,2119,0.22746578574799434,1637
15,1758335955529584786,1758335955768733914,239.149,458,482,2195,1146,3341,42,42,2195,0.21958997722095672,1713
16,1758336557730866789,1758336559645918621,1915.052,458,482,2602,1030,3632,39,39,2602,0.18524212144504226,2120
17,1758337156929363032,1758337156941712245,12.349,458,482,2423,1286,3709,47,47,2423,0.19892695006190672,1941
18,1758337758145997623,1758337758159547622,13.55,458,482,1967,902,2869,35,35,1967,0.24504321301474327,1485
19,1758338357338180251,1758338357351781135,13.601,458,482,2143,1082,3225,40,40,2143,0.22491833877741485,1661
20,1758338956542891986,1758338956675510253,132.618,458,482,2119,1030,3149,39,39,2119,0.22746578574799434,1637
21,1758339555748501297,1758339555813172225,64.671,458,482,1967,902,2869,35,35,1967,0.24504321301474327,1485
22,1758340155956587571,1758340156187963340,231.376,458,482,2195,1146,3341,42,42,2195,0.21958997722095672,1713
23,1758340756172766265,1758340756276884835,104.119,458,482,2119,1030,3149,39,39,2119,0.22746578574799434,1637
24,1758341356362426867,1758341356432450657,70.024,458,482,2271,1210,3481,44,44,2271,0.21224130339057684,1789
25,1758341955567516708,1758341955659997763,92.481,458,482,2271,1158,3429,43,43,2271,0.21224130339057684,1789
26,1758342555765066829,1758342555794296134,29.229,458,482,2119,1030,3149,39,39,2119,0.22746578574799434,1637
27,1758343157963187348,1758343158219080426,255.893,458,482,2043,966,3009,37,37,2043,0.2359275575134606,1561
28,1758343756175814714,1758343756446986558,271.172,458,482,2271,1158,3429,43,43,2271,0.21224130339057684,1789
29,1758344357365072430,1758344357529588479,164.516,458,482,2043,1018,3061,38,38,2043,0.2359275575134606,1561
30,1758344956571267252,1758344956830436993,259.17,458,482,2119,1030,3149,39,39,2119,0.22746578574799434,1637
31,1758345555779745369,1758345558108585902,2328.841,458,482,2678,1094,3772,41,41,2678,0.17998506348020912,2196
32,1758346160992933335,1758346161796103505,803.17,458,482,2195,1094,3289,41,41,2195,0.21958997722095672,1713
33,1758346757208437701,1758346757221673165,13.235,458,482,2119,1030,3149,39,39,2119,0.22746578574799434,1637
34,1758347357418053905,1758347357489687564,71.634,458,482,2143,1082,3225,40,40,2143,0.22491833877741485,1661
35,1758347955604542263,1758347955685014661,80.472,458,482,2119,1082,3201,40,40,2119,0.22746578574799434,1637
36,1758348557797436864,1758348558045351328,247.914,458,482,1967,902,2869,35,35,1967,0.24504321301474327,1485
37,1758349158002281583,1758349158172397348,170.116,458,482,2195,1094,3289,41,41,2195,0.21958997722095672,1713
38,1758349757194682407,1758349757238319339,43.637,458,482,2423,1286,3709,47,47,2423,0.19892695006190672,1941
39,1758350359381409496,1758350360477731450,1096.322,458,482,2119,1030,3149,39,39,2119,0.22746578574799434,1637
40,1758350957587221336,1758350957748936070,161.715,458,482,2195,1094,3289,41,41,2195,0.21958997722095672,1713
41,1758351569791820543,1758351569817299982,25.479,458,482,2119,1030,3149,39,39,2119,0.22746578574799434,1637
42,1758352155994680466,1758352156113424024,118.744,458,482,2195,1094,3289,41,41,2195,0.21958997722095672,1713
43,1758352756212158071,1758352756405950792,193.793,458,482,2043,1018,3061,38,38,2043,0.2359275575134606,1561
44,1758353356421213324,1758353356460107483,38.894,458,482,2043,966,3009,37,37,2043,0.2359275575134606,1561
45,1758353955615972651,1758353955643425545,27.453,458,482,2347,1274,3621,46,46,2347,0.20536855560289732,1865
46,1758354555815422715,1758354556078555034,263.132,458,482,2119,1030,3149,39,39,2119,0.22746578574799434,1637
47,1758355156031582036,1758355156256110552,224.529,458,482,2043,1070,3113,39,39,2043,0.2359275575134606,1561
48,1758355757248367487,1758355757258999636,10.632,458,482,1967,902,2869,35,35,1967,0.24504321301474327,1485
49,1758356355458527929,1758356355469102225,10.574,458,482,1991,954,2945,36,36,1991,0.24208940231039677,1509
50,1758356958657765841,1758356958883104598,225.339,458,482,2143,1094,3237,40,40,2143,0.22491833877741485,1661
51,1758357558847501837,1758357559089775111,242.273,458,482,1967,902,2869,35,35,1967,0.24504321301474327,1485
52,1758358156045559351,1758358156329005215,283.446,458,482,2347,1222,3569,45,45,2347,0.20536855560289732,1865
53,1758358758246670711,1758358758362054573,115.384,458,482,2347,1222,3569,45,45,2347,0.20536855560289732,1865
54,1758359355430509424,1758359356004792278,574.283,458,482,2043,1018,3061,38,38,2043,0.2359275575134606,1561
55,1758359955633951601,1758359955675058504,41.107,458,482,2195,1094,3289,41,41,2195,0.21958997722095672,1713
56,1758360555831133144,1758360555971204112,140.071,458,482,2119,1030,3149,39,39,2119,0.22746578574799434,1637
57,1758361165048278800,1758361165254166497,205.888,458,482,2271,1262,3533,45,45,2271,0.21224130339057684,1789
58,1758361756242116201,1758361756477042141,234.926,458,482,2195,1094,3289,41,41,2195,0.21958997722095672,1713
59,1758362357450623503,1758362357561252935,110.629,458,482,2119,1030,3149,39,39,2119,0.22746578574799434,1637
60,1758362966663306218,1758362967319366847,656.061,458,482,2119,1134,3253,41,41,2119,0.22746578574799434,1637
61,1758363555865972901,1758363556145995190,280.022,458,482,1967,902,2869,35,35,1967,0.24504321301474327,1485
62,1758364156084984929,1758364156108602257,23.617,458,482,2195,1094,3289,41,41,2195,0.21958997722095672,1713
63,1758364757300996774,1758364757314165169,13.168,458,482,2119,1030,3149,39,39,2119,0.22746578574799434,1637
64,1758365355509100662,1758365355522759989,13.659,458,482,2171,1194,3365,42,42,2171,0.2220175034546292,1689
65,1758365955697970229,1758365955968086103,270.116,458,482,2043,966,3009,37,37,2043,0.2359275575134606,1561
66,1758366556901856949,1758366558241556693,1339.7,458,482,2578,978,3556,38,38,2578,0.186966640806827,2096
67,1758367167130788810,1758367167143679166,12.89,458,482,1991,1058,3049,38,38,1991,0.24208940231039677,1509
68,1758367759337703009,1758367759458628223,120.925,458,482,2119,1030,3149,39,39,2119,0.22746578574799434,1637
69,1758368355522141383,1758368355786413376,264.272,458,482,2271,1210,3481,44,44,2271,0.21224130339057684,1789
70,1758368956732340295,1758368956876094149,143.754,458,482,2043,966,3009,37,37,2043,0.2359275575134606,1561
71,1758369558940362641,1758369559198041633,257.679,458,482,2119,1082,3201,40,40,2119,0.22746578574799434,1637
72,1758370157159304157,1758370157213290485,53.986,458,482,1967,902,2869,35,35,1967,0.24504321301474327,1485
73,1758370756364418089,1758370756618210010,253.792,458,482,2271,1158,3429,43,43,2271,0.21224130339057684,1789
74,1758371358572355278,1758371358646767202,74.412,458,482,2195,1094,3289,41,41,2195,0.21958997722095672,1713
75,1758371955758720212,1758371956082734672,324.014,458,482,2451,1450,3901,50,50,2451,0.1966544267645859,1969
76,1758372557942137910,1758372558145613080,203.475,458,482,2171,1118,3289,41,41,2171,0.2220175034546292,1689
77,1758373156164200418,1758373156191904931,27.705,458,482,2043,966,3009,37,37,2043,0.2359275575134606,1561
78,1758373757373178224,1758373757386820468,13.642,458,482,1967,902,2869,35,35,1967,0.24504321301474327,1485
79,1758374355576952673,1758374355626986034,50.033,458,482,1891,838,2729,33,33,1891,0.2548915917503966,1409
80,1758374955775731319,1758374955788506674,12.775,458,482,1891,838,2729,33,33,1891,0.2548915917503966,1409
81,1758375555982759420,1758375556168688930,185.93,458,482,1891,838,2729,33,33,1891,0.2548915917503966,1409
82,1758376156199410142,1758376156440635132,241.225,458,482,1891,838,2729,33,33,1891,0.2548915917503966,1409
83,1758376758387565002,1758376758554971829,167.407,458,482,1763,762,2525,30,30,1763,0.2733976176971072,1281
84,1758377355569528925,1758377355754663987,185.135,458,482,1891,838,2729,33,33,1891,0.2548915917503966,1409
85,1758377955774915010,1758377956025599073,250.684,458,482,1891,838,2729,33,33,1891,0.2548915917503966,1409
86,1758378555981465440,1758378556297478830,316.013,458,482,1891,838,2729,33,33,1891,0.2548915917503966,1409
87,1758379156198042941,1758379156261533279,63.49,458,482,1891,838,2729,33,33,1891,0.2548915917503966,1409
88,1758379756410910947,1758379756532967518,122.057,458,482,1891,838,2729,33,33,1891,0.2548915917503966,1409
89,1758380356620827080,1758380356803419836,182.593,458,482,1891,838,2729,33,33,1891,0.2548915917503966,1409
90,1758380955820646333,1758380955845200356,24.554,458,482,1891,838,2729,33,33,1891,0.2548915917503966,1409
91,1758381556034485879,1758381556117402929,82.917,458,482,1891,838,2729,33,33,1891,0.2548915917503966,1409
92,1758382156248890604,1758382156381860995,132.97,458,482,2347,1274,3621,46,46,2347,0.20536855560289732,1865
93,1758382756437820830,1758382756695148100,257.327,458,482,2043,966,3009,37,37,2043,0.2359275575134606,1561
94,1758383355643936059,1758383355794798384,150.862,458,482,2043,966,3009,37,37,2043,0.2359275575134606,1561
95,1758383955847232363,1758383955949046362,101.814,458,482,2271,1210,3481,44,44,2271,0.21224130339057684,1789
96,1758384557062927711,1758384557325518895,262.591,458,482,2195,1094,3289,41,41,2195,0.21958997722095672,1713
97,1758385156277007520,1758385156524917530,247.91,458,482,2195,1094,3289,41,41,2195,0.21958997722095672,1713
98,1758385756474450782,1758385756526026652,51.576,458,482,1967,902,2869,35,35,1967,0.24504321301474327,1485
99,1758386355660425698,1758386355814368702,153.943,458,482,2119,1030,3149,39,39,2119,0.22746578574799434,1637
100,1758386955846526192,1758386955859154250,12.628,463,487,2200,1094,3294,41,41,2200,0.22136363636363637,1713
101,1758387556033981508,1758387556046710428,12.729,463,487,2148,1082,3230,40,40,2148,0.22672253258845437,1661
102,1758388157247893638,1758388157457425884,209.532,463,487,1920,902,2822,34,34,1920,0.25364583333333335,1433
103,1758388756442429485,1758388757813003754,1370.574,463,487,2840,1274,4114,46,46,2840,0.1714788732394366,2353
104,1758389355648092338,1758389358270714798,2622.622,459,483,2680,1094,3774,41,41,2680,0.1802238805970149,2197
105,1758389955843991076,1758389955897387098,53.396,463,487,2124,1030,3154,39,39,2124,0.2292843691148776,1637
106,1758390557052615927,1758390559300009748,2247.394,459,483,2680,1094,3774,41,41,2680,0.1802238805970149,2197
107,1758391156258899263,1758391156556827955,297.929,459,483,2196,1094,3290,41,41,2196,0.21994535519125682,1713
108,1758391757449364050,1758391757497035747,47.672,463,487,2276,1210,3486,44,44,2276,0.2139718804920914,1789
109,1758392357643750012,1758392357848068221,204.318,463,487,2124,1030,3154,39,39,2124,0.2292843691148776,1637
110,1758392957841733136,1758392957943946900,102.214,463,487,2200,1094,3294,41,41,2200,0.22136363636363637,1713
111,1758393556053749137,1758393556344865846,291.117,463,487,2276,1158,3434,43,43,2276,0.2139718804920914,1789
112,1758394158239288329,1758394158355400859,116.113,463,487,2200,1146,3346,42,42,2200,0.22136363636363637,1713
113,1758394758447178198,1758394758492107464,44.929,463,487,2200,1094,3294,41,41,2200,0.22136363636363637,1713
114,1758395356652272117,1758395356756111460,103.839,463,487,2124,1030,3154,39,39,2124,0.2292843691148776,1637
115,1758395955835868433,1758395955954374247,118.506,463,487,2200,1094,3294,41,41,2200,0.22136363636363637,1713
116,1758396558051626499,1758396558064424569,12.798,459,483,2120,1030,3150,39,39,2120,0.2278301886792453,1637
117,1758397156262243512,1758397156275884177,13.641,463,487,2200,1094,3294,41,41,2200,0.22136363636363637,1713
118,1758397758456834858,1758397758470690087,13.855,463,487,2148,1082,3230,40,40,2148,0.22672253258845437,1661
119,1758398356660187848,1758398356869293512,209.106,463,487,1896,838,2734,33,33,1896,0.2568565400843882,1409
120,1758398959859773926,1758398960003748123,143.974,463,487,2504,1350,3854,49,49,2504,0.1944888178913738,2017
121,1758399556073444272,1758399556358673029,285.229,463,487,2276,1158,3434,43,43,2276,0.2139718804920914,1789
122,1758400156284042090,1758400156305905222,21.863,459,483,2196,1094,3290,41,41,2196,0.21994535519125682,1713
123,1758400755479818133,1758400755637681245,157.863,463,487,2124,1030,3154,39,39,2124,0.2292843691148776,1637
124,1758401358668607554,1758401358703702314,35.095,463,487,2276,1210,3486,44,44,2276,0.2139718804920914,1789
125,1758401957853818315,1758401958126307546,272.489,459,483,2196,1094,3290,41,41,2196,0.21994535519125682,1713
126,1758402556071193423,1758402556196507638,125.314,463,487,2048,966,3014,37,37,2048,0.23779296875,1561
127,1758403156288552370,1758403156381946229,93.394,459,483,2120,1030,3150,39,39,2120,0.2278301886792453,1637
128,1758403758501210969,1758403758563224347,62.013,459,483,2196,1094,3290,41,41,2196,0.21994535519125682,1713
129,1758404358709221600,1758404358891775755,182.554,463,487,2276,1210,3486,44,44,2276,0.2139718804920914,1789
130,1758404958908570149,1758404959059967217,151.397,463,487,2276,1210,3486,44,44,2276,0.2139718804920914,1789
131,1758405556125420712,1758405556138970035,13.549,463,487,2048,966,3014,37,37,2048,0.23779296875,1561
132,1758406161317114307,1758406161330018648,12.904,463,487,2148,1082,3230,40,40,2148,0.22672253258845437,1661
133,1758406755520542120,1758406756290448653,769.907,459,483,2120,1030,3150,39,39,2120,0.2278301886792453,1637
134,1758407357712180235,1758407357854063100,141.883,463,487,2148,1094,3242,40,40,2148,0.22672253258845437,1661
135,1758407957895352158,1758407958341509717,446.158,463,487,2200,1094,3294,41,41,2200,0.22136363636363637,1713
136,1758408558116085546,1758408558316097665,200.012,463,487,2124,1030,3154,39,39,2124,0.2292843691148776,1637
137,1758409157324914971,1758409157382798278,57.883,463,487,2048,1018,3066,38,38,2048,0.23779296875,1561
138,1758409757529665085,1758409757560011434,30.346,459,483,2120,1030,3150,39,39,2120,0.2278301886792453,1637
139,1758410355720298502,1758410356281873126,561.575,463,487,2200,1094,3294,41,41,2200,0.22136363636363637,1713
140,1758410956899327488,1758410957083456934,184.129,463,487,2200,1094,3294,41,41,2200,0.22136363636363637,1713
141,1758411556114363552,1758411556259953514,145.59,463,487,2200,1146,3346,42,42,2200,0.22136363636363637,1713
142,1758412159325179403,1758412159409659268,84.48,463,487,2048,966,3014,37,37,2048,0.23779296875,1561
143,1758412756529798862,1758412758078411782,1548.613,463,487,2764,1158,3922,43,43,2764,0.17619392185238783,2277
144,1758413358729476494,1758413359000508123,271.032,463,487,2048,966,3014,37,37,2048,0.23779296875,1561
145,1758413956925399272,1758413958215555847,1290.157,463,487,2840,1274,4114,46,46,2840,0.1714788732394366,2353
146,1758414557145345689,1758414557301311629,155.966,463,487,2124,1030,3154,39,39,2124,0.2292843691148776,1637
147,1758415155358652955,1758415155364652355,5.999,463,487,2124,1030,3154,39,39,2124,0.2292843691148776,1637
148,1758415757557210022,1758415757566803648,9.594,463,487,1996,1006,3002,37,37,1996,0.2439879759519038,1509
149,1758416356741845529,1758416357230572018,488.726,463,487,2124,1082,3206,40,40,2124,0.2292843691148776,1637
150,1758416955945330652,1758416956206881263,261.551,463,487,2048,966,3014,37,37,2048,0.23779296875,1561
151,1758417556167304396,1758417556222156470,54.852,463,487,2124,1030,3154,39,39,2124,0.2292843691148776,1637
152,1758418164381469724,1758418165853206904,1471.737,463,487,2764,1158,3922,43,43,2764,0.17619392185238783,2277
153,1758418758581357238,1758418758814966539,233.609,463,487,2200,1094,3294,41,41,2200,0.22136363636363637,1713
154,1758419355771354675,1758419355848694408,77.34,463,487,2352,1222,3574,45,45,2352,0.2070578231292517,1865
155,1758419957976726142,1758419958222560235,245.834,459,483,2272,1158,3430,43,43,2272,0.2125880281690141,1789
156,1758420558183234784,1758420558348083388,164.849,463,487,2124,1030,3154,39,39,2124,0.2292843691148776,1637
157,1758421156391838492,1758421156618138049,226.3,463,487,2200,1094,3294,41,41,2200,0.22136363636363637,1713
158,1758421755595988454,1758421755728560693,132.572,463,487,2276,1158,3434,43,43,2276,0.2139718804920914,1789
159,1758422358796583196,1758422359109755576,313.172,463,487,2200,1146,3346,42,42,2200,0.22136363636363637,1713
160,1758422955997278060,1758422957689087084,1691.809,463,487,2612,1030,3642,39,39,2612,0.18644716692189892,2125
161,1758423556194196531,1758423556502366532,308.17,463,487,2124,1030,3154,39,39,2124,0.2292843691148776,1637
162,1758424161406687169,1758424161511616079,104.929,459,483,2272,1314,3586,46,46,2272,0.2125880281690141,1789
163,1758424755612298619,1758424755621165552,8.867,463,487,2276,1158,3434,43,43,2276,0.2139718804920914,1789
164,1758425355808839553,1758425355821684554,12.845,459,483,2044,966,3010,37,37,2044,0.2363013698630137,1561
165,1758425958023871627,1758425958037238045,13.366,463,487,1996,954,2950,36,36,1996,0.2439879759519038,1509
166,1758426559240735947,1758426559382246608,141.511,463,487,2048,966,3014,37,37,2048,0.23779296875,1561
167,1758427156438803693,1758427156749399546,310.596,463,487,2124,1082,3206,40,40,2124,0.2292843691148776,1637
168,1758427756628973565,1758427756928034310,299.061,463,487,2048,966,3014,37,37,2048,0.23779296875,1561
169,1758428357831862332,1758428358030466293,198.604,463,487,2124,1030,3154,39,39,2124,0.2292843691148776,1637
170,1758428968045815050,1758428969835422145,1789.607,463,487,2764,1158,3922,43,43,2764,0.17619392185238783,2277
171,1758429558256966302,1758429558365045887,108.08,459,483,2120,1030,3150,39,39,2120,0.2278301886792453,1637
172,1758430156465471915,1758430156479335345,13.863,463,487,1972,902,2874,35,35,1972,0.24695740365111563,1485
173,1758430757671746644,1758430760165141354,2493.395,463,487,2688,1094,3782,41,41,2688,0.18117559523809523,2201
174,1758431355870058822,1758431356187183308,317.124,463,487,2276,1158,3434,43,43,2276,0.2139718804920914,1789
175,1758431956089816791,1758431956278748789,188.932,463,487,2200,1094,3294,41,41,2200,0.22136363636363637,1713
176,1758432556301422720,1758432556483912533,182.49,463,487,2200,1094,3294,41,41,2200,0.22136363636363637,1713
177,1758433155498229703,1758433155511965573,13.736,463,487,2048,1018,3066,38,38,2048,0.23779296875,1561
178,1758433755701459148,1758433755714844119,13.385,459,483,2196,1094,3290,41,41,2196,0.21994535519125682,1713
179,1758434355901739364,1758434355914815418,13.076,463,487,1920,890,2810,34,34,1920,0.25364583333333335,1433
180,1758434958123584911,1758434958276337866,152.753,463,487,2148,1094,3242,40,40,2148,0.22672253258845437,1661
181,1758435556329994146,1758435556478587035,148.593,459,483,2196,1094,3290,41,41,2196,0.21994535519125682,1713
182,1758436157512568855,1758436157767530220,254.961,463,487,2124,1030,3154,39,39,2124,0.2292843691148776,1637
183,1758436757716687802,1758436757992062551,275.375,459,483,2272,1158,3430,43,43,2272,0.2125880281690141,1789
184,1758437366918164888,1758437367091579994,173.415,463,487,2200,1094,3294,41,41,2200,0.22136363636363637,1713
185,1758437966137184234,1758437966357590425,220.406,463,487,2048,966,3014,37,37,2048,0.23779296875,1561
186,1758438556338254221,1758438556351773883,13.52,459,483,2272,1158,3430,43,43,2272,0.2125880281690141,1789
187,1758439155524256438,1758439155719858915,195.602,463,487,2276,1158,3434,43,43,2276,0.2139718804920914,1789
188,1758439757733646003,1758439757950001848,216.356,459,483,1968,902,2870,35,35,1968,0.24542682926829268,1485
189,1758440355937402216,1758440356176682201,239.28,463,487,1896,838,2734,33,33,1896,0.2568565400843882,1409
190,1758440956149431110,1758440956448187674,298.757,463,487,1896,838,2734,33,33,1896,0.2568565400843882,1409
191,1758441557355786668,1758441557430134216,74.348,463,487,2352,1274,3626,46,46,2352,0.2070578231292517,1865
192,1758442158546714698,1758442158805686834,258.972,459,483,2044,1018,3062,38,38,2044,0.2363013698630137,1561
193,1758442755749678296,1758442756021180297,271.502,459,483,2272,1158,3430,43,43,2272,0.2125880281690141,1789
194,1758443355955829462,1758443355963174099,7.345,463,487,2124,1082,3206,40,40,2124,0.2292843691148776,1637
195,1758443958167231541,1758443958180579189,13.348,463,487,1996,954,2950,36,36,1996,0.2439879759519038,1509
196,1758444556377944160,1758444556807007791,429.064,463,487,2200,1106,3306,41,41,2200,0.22136363636363637,1713
197,1758445166582308145,1758445166595718862,13.411,463,487,1996,954,2950,36,36,1996,0.2439879759519038,1509
198,1758445755781467414,1758445756013180560,231.713,463,487,2276,1158,3434,43,43,2276,0.2139718804920914,1789
199,1758446357991591913,1758446359504849369,1513.257,459,483,2756,1158,3914,43,43,2756,0.17525399129172714,2273
200,1758446956204247907,1758446956521797318,317.549,463,487,2124,1082,3206,40,40,2124,0.2292843691148776,1637
201,1758447559406370877,1758447559424395379,18.025,463,487,2352,1222,3574,45,45,2352,0.2070578231292517,1865
202,1758448155613078821,1758448155721039955,107.961,459,483,1892,838,2730,33,33,1892,0.25528541226215645,1409
203,1758448759818125777,1758448759847693731,29.568,463,487,2276,1158,3434,43,43,2276,0.2139718804920914,1789
204,1758449358033758153,1758449358261182642,227.424,463,487,2200,1094,3294,41,41,2200,0.22136363636363637,1713
205,1758449957249005575,1758449957461523911,212.518,463,487,2124,1030,3154,39,39,2124,0.2292843691148776,1637
206,1758450557458751593,1758450558893205610,1434.454,463,487,2764,1210,3974,44,44,2764,0.17619392185238783,2277
207,1758451155642395468,1758451155842104995,199.71,459,483,2120,1082,3202,40,40,2120,0.2278301886792453,1637
208,1758451756841347321,1758451756980462699,139.115,463,487,2276,1158,3434,43,43,2276,0.2139718804920914,1789
209,1758452357056728746,1758452357067000741,10.272,463,487,2048,966,3014,37,37,2048,0.23779296875,1561
210,1758452956262318723,1758452956275598638,13.28,463,487,1920,942,2862,35,35,1920,0.25364583333333335,1433
211,1758453556467278274,1758453558111497131,1644.219,463,487,2200,1094,3294,41,41,2200,0.22136363636363637,1713
212,1758454155660249402,1758454155864835786,204.586,463,487,2200,1094,3294,41,41,2200,0.22136363636363637,1713
213,1758454755847446223,1758454756076156567,228.71,463,487,2048,966,3014,37,37,2048,0.23779296875,1561
214,1758455356036331194,1758455356258397003,222.066,459,483,1968,902,2870,35,35,1968,0.24542682926829268,1485
215,1758455956247996358,1758455956382282374,134.286,463,487,1972,902,2874,35,35,1972,0.24695740365111563,1485
216,1758456556456840354,1758456556757942959,301.103,463,487,2124,1030,3154,39,39,2124,0.2292843691148776,1637
217,1758457157656695553,1758457157936348217,279.653,459,483,2044,966,3010,37,37,2044,0.2363013698630137,1561
218,1758457755849487325,1758457755900521319,51.034,463,487,2276,1158,3434,43,43,2276,0.2139718804920914,1789
219,1758458357067166227,1758458357353421683,286.255,463,487,2200,1094,3294,41,41,2200,0.22136363636363637,1713
220,1758458956254341910,1758458956361305271,106.963,463,487,2048,966,3014,37,37,2048,0.23779296875,1561
221,1758459557467700973,1758459557498866706,31.166,463,487,2352,1222,3574,45,45,2352,0.2070578231292517,1865
222,1758460158672012547,1758460158970478981,298.466,463,487,2200,1094,3294,41,41,2200,0.22136363636363637,1713
223,1758460759870787934,1758460760178544388,307.756,459,483,2196,1146,3342,42,42,2196,0.21994535519125682,1713
224,1758461356088077279,1758461356387924172,299.847,463,487,2264,1402,3666,47,47,2264,0.2151060070671378,1777
225,1758461956300252299,1758461956527464947,227.213,459,483,1892,890,2782,34,34,1892,0.25528541226215645,1409
226,1758462557506734550,1758462559260447369,1753.713,463,487,2200,1106,3306,41,41,2200,0.22136363636363637,1713
227,1758463167712896768,1758463167811192022,98.295,463,487,1768,762,2530,30,30,1768,0.2754524886877828,1281
228,1758463755909577820,1758463756120875728,211.298,463,487,2276,1158,3434,43,43,2276,0.2139718804920914,1789
229,1758464357104573219,1758464357247732782,143.16,463,487,2200,1094,3294,41,41,2200,0.22136363636363637,1713
230,1758464956318083523,1758464956612377508,294.294,463,487,2124,1030,3154,39,39,2124,0.2292843691148776,1637
231,1758465558525928321,1758465558692702487,166.774,463,487,2428,1338,3766,48,48,2428,0.20057660626029655,1941
232,1758466155720990201,1758466155923639281,202.649,463,487,2200,1094,3294,41,41,2200,0.22136363636363637,1713
233,1758466758909583816,1758466758961746922,52.163,463,487,2200,1094,3294,41,41,2200,0.22136363636363637,1713
234,1758467374125943524,1758467374202394045,76.451,459,483,2044,966,3010,37,37,2044,0.2363013698630137,1561
235,1758467956305758676,1758467956557421402,251.663,463,487,2352,1222,3574,45,45,2352,0.2070578231292517,1865
236,1758468556511904294,1758468556754524785,242.62,463,487,2048,966,3014,37,37,2048,0.23779296875,1561
237,1758469155716683132,1758469156030498899,313.816,463,487,2276,1158,3434,43,43,2276,0.2139718804920914,1789
238,1758469757919241592,1758469757932320838,13.079,463,487,2124,1030,3154,39,39,2124,0.2292843691148776,1637
239,1758470356140276380,1758470356217084969,76.809,463,487,2124,1030,3154,39,39,2124,0.2292843691148776,1637
240,1758470957350732866,1758470957363500212,12.767,459,483,1916,890,2806,34,34,1916,0.2520876826722338,1433
241,1758471556549584486,1758471556708859889,159.275,463,487,2124,1030,3154,39,39,2124,0.2292843691148776,1637
242,1758472155736851515,1758472155912596439,175.745,463,487,2200,1094,3294,41,41,2200,0.22136363636363637,1713
243,1758472755947225260,1758472756175134000,227.909,459,483,2120,1134,3254,41,41,2120,0.2278301886792453,1637
244,1758473356156490019,1758473356207855467,51.365,463,487,2124,1030,3154,39,39,2124,0.2292843691148776,1637
245,1758473957362577611,1758473957509243629,146.666,463,487,2276,1158,3434,43,43,2276,0.2139718804920914,1789
246,1758474556568301067,1758474556735411686,167.111,463,487,2276,1158,3434,43,43,2276,0.2139718804920914,1789
247,1758475155763514922,1758475156051819518,288.305,463,487,2124,1030,3154,39,39,2124,0.2292843691148776,1637
248,1758475757966073016,1758475758014021972,47.949,463,487,2352,1222,3574,45,45,2352,0.2070578231292517,1865
249,1758476356174519233,1758476356188558313,14.039,463,487,2200,1094,3294,41,41,2200,0.22136363636363637,1713
250,1758476959361944642,1758476959453182593,91.238,459,483,2272,1158,3430,43,43,2272,0.2125880281690141,1789
251,1758477557565990509,1758477557823131189,257.141,463,487,2048,966,3014,37,37,2048,0.23779296875,1561
252,1758478158768927470,1758478159015659237,246.732,463,487,2048,966,3014,37,37,2048,0.23779296875,1561
253,1758478761978396628,1758478762170149319,191.753,459,483,2348,1222,3570,45,45,2348,0.20570698466780238,1865
254,1758479360192657256,1758479360206032535,13.375,463,487,2352,1222,3574,45,45,2352,0.2070578231292517,1865
255,1758479956400218315,1758479956413547343,13.329,463,487,1920,942,2862,35,35,1920,0.25364583333333335,1433
256,1758480555598009699,1758480557268891293,1670.882,463,487,2688,1094,3782,41,41,2688,0.18117559523809523,2201
257,1758481158787965371,1758481159019178369,231.213,463,487,2200,1094,3294,41,41,2200,0.22136363636363637,1713
258,1758481757968594665,1758481758266236127,297.641,463,487,2124,1082,3206,40,40,2124,0.2292843691148776,1637
259,1758482358181339075,1758482358267145056,85.806,463,487,2124,1030,3154,39,39,2124,0.2292843691148776,1637
260,1758482959390344034,1758482959426640693,36.297,463,487,2124,1030,3154,39,39,2124,0.2292843691148776,1637
261,1758483557578062303,1758483557830339644,252.277,463,487,2276,1158,3434,43,43,2276,0.2139718804920914,1789
262,1758484155765500911,1758484157139575151,1374.074,463,487,1972,954,2926,36,36,1972,0.24695740365111563,1485
263,1758484755963103927,1758484755992699104,29.595,463,487,2276,1158,3434,43,43,2276,0.2139718804920914,1789
264,1758485359183608238,1758485359277148609,93.54,463,487,1972,902,2874,35,35,1972,0.24695740365111563,1485
265,1758485956392410894,1758485956833879977,441.469,463,487,2048,966,3014,37,37,2048,0.23779296875,1561
266,1758486557581615175,1758486557621554001,39.939,463,487,2200,1094,3294,41,41,2200,0.22136363636363637,1713
267,1758487155763951707,1758487156088406429,324.455,463,487,1972,902,2874,35,35,1972,0.24695740365111563,1485
268,1758487755950362266,1758487756032064887,81.703,463,487,2200,1094,3294,41,41,2200,0.22136363636363637,1713
269,1758488357168015567,1758488357180886421,12.871,459,483,2196,1094,3290,41,41,2196,0.21994535519125682,1713
270,1758488958384487890,1758488958394317716,9.83,463,487,1996,954,2950,36,36,1996,0.2439879759519038,1509
271,1758489555582080463,1758489556556745808,974.665,463,487,2072,1030,3102,38,38,2072,0.23503861003861004,1585
272,1758490158777766394,1758490158872354604,94.588,463,487,2200,1094,3294,41,41,2200,0.22136363636363637,1713
273,1758490755974123943,1758490756194129861,220.006,459,483,2044,966,3010,37,37,2044,0.2363013698630137,1561
274,1758491356180958349,1758491356609371112,428.413,459,483,2348,1222,3570,45,45,2348,0.20570698466780238,1865
275,1758491956393245633,1758491956633817442,240.572,463,487,2352,1274,3626,46,46,2352,0.2070578231292517,1865
276,1758492565605987398,1758492565848069908,242.083,463,487,2200,1094,3294,41,41,2200,0.22136363636363637,1713
277,1758493158801604549,1758493159157828831,356.224,463,487,2048,1018,3066,38,38,2048,0.23779296875,1561
278,1758493756007417068,1758493756114392538,106.975,459,483,2196,1094,3290,41,41,2196,0.21994535519125682,1713
279,1758494367234847053,1758494367329263824,94.417,463,487,2276,1158,3434,43,43,2276,0.2139718804920914,1789
280,1758494958441332364,1758494959624805219,1183.473,463,487,2048,966,3014,37,37,2048,0.23779296875,1561
281,1758495560636166766,1758495560646277573,10.111,463,487,2124,1030,3154,39,39,2124,0.2292843691148776,1637
282,1758496155812576449,1758496155978242955,165.667,459,483,2196,1094,3290,41,41,2196,0.21994535519125682,1713
283,1758496766033051146,1758496766271571679,238.521,463,487,2124,1030,3154,39,39,2124,0.2292843691148776,1637
284,1758497356241934648,1758497356486502779,244.568,463,487,1972,902,2874,35,35,1972,0.24695740365111563,1485
285,1758497956427183076,1758497956461474301,34.291,463,487,2048,966,3014,37,37,2048,0.23779296875,1561
286,1758498555632620428,1758498555642413078,9.793,463,487,2048,966,3014,37,37,2048,0.23779296875,1561
287,1758499157834852659,1758499157847773960,12.921,463,487,2072,1018,3090,38,38,2072,0.23503861003861004,1585
288,1758499757050342219,1758499757222951855,172.61,459,483,2272,1158,3430,43,43,2272,0.2125880281690141,1789
289,1758500359265090792,1758500359562715123,297.624,463,487,2276,1210,3486,44,44,2276,0.2139718804920914,1789
290,1758500958469255868,1758500960264651075,1795.395,463,487,2688,1094,3782,41,41,2688,0.18117559523809523,2201
291,1758501557653733532,1758501558730412058,1076.679,459,483,2196,1094,3290,41,41,2196,0.21994535519125682,1713
292,1758502155843482055,1758502155997163206,153.681,463,487,2124,1030,3154,39,39,2124,0.2292843691148776,1637
293,1758502766064016703,1758502766122866327,58.85,463,487,2124,1030,3154,39,39,2124,0.2292843691148776,1637
294,1758503357280963252,1758503357540750566,259.787,459,483,2120,1030,3150,39,39,2120,0.2278301886792453,1637
295,1758503959488384603,1758503959809206038,320.821,459,483,2272,1158,3430,43,43,2272,0.2125880281690141,1789
296,1758504556699871105,1758504556804098999,104.228,463,487,1972,902,2874,35,35,1972,0.24695740365111563,1485
297,1758505155884558970,1758505156172649164,288.09,463,487,2276,1210,3486,44,44,2276,0.2139718804920914,1789
298,1758505756092632348,1758505756262193761,169.561,459,483,2120,1030,3150,39,39,2120,0.2278301886792453,1637
299,1758506359306947343,1758506359654870084,347.923,463,487,2276,1210,3486,44,44,2276,0.2139718804920914,1789
300,1758506955517382851,1758506955531328600,13.946,463,487,2124,1030,3154,39,39,2124,0.2292843691148776,1637
301,1758507555727922025,1758507556204857438,476.935,463,487,2276,1158,3434,43,43,2276,0.2139718804920914,1789
302,1758508155935125079,1758508155947708351,12.583,463,487,2072,1018,3090,38,38,2072,0.23503861003861004,1585
303,1758508757153748044,1758508757312608822,158.861,463,487,2200,1094,3294,41,41,2200,0.22136363636363637,1713
304,1758509358364151344,1758509360191102699,1826.951,463,487,2612,1030,3642,39,39,2612,0.18644716692189892,2125
305,1758509957553713609,1758509957647070909,93.357,463,487,2200,1094,3294,41,41,2200,0.22136363636363637,1713
306,1758510557734265621,1758510557979087888,244.822,463,487,2352,1222,3574,45,45,2352,0.2070578231292517,1865
307,1758511155932315951,1758511157528833808,1596.518,463,487,2840,1274,4114,46,46,2840,0.1714788732394366,2353
308,1758511759156105498,1758511759259717177,103.612,463,487,2276,1158,3434,43,43,2276,0.2139718804920914,1789
309,1758512356354969103,1758512356529934744,174.966,463,487,2352,1158,3510,44,44,2352,0.2070578231292517,1865
310,1758512957540114491,1758512959144818060,1604.704,459,483,2756,1210,3966,44,44,2756,0.17525399129172714,2273
311,1758513555738463836,1758513558709494127,2971.03,463,487,3176,1094,4270,41,41,3176,0.1533375314861461,2689
312,1758514155937295456,1758514156164086574,226.791,463,487,2048,966,3014,37,37,2048,0.23779296875,1561
313,1758514758155849146,1758514758223180917,67.332,459,483,2120,1030,3150,39,39,2120,0.2278301886792453,1637
314,1758515356338838249,1758515356640522833,301.685,459,483,2196,1094,3290,41,41,2196,0.21994535519125682,1713
315,1758515955545081717,1758515955555223679,10.142,463,487,2352,1274,3626,46,46,2352,0.2070578231292517,1865
316,1758516557750777811,1758516557764110017,13.332,463,487,1896,838,2734,33,33,1896,0.2568565400843882,1409
317,1758517155947535921,1758517156133229346,185.693,459,483,2068,1070,3138,39,39,2068,0.23355899419729206,1585
318,1758517756167874083,1758517756668446687,500.573,463,487,2072,1030,3102,38,38,2072,0.23503861003861004,1585
319,1758518356374250291,1758518356693107744,318.857,463,487,2200,1146,3346,42,42,2200,0.22136363636363637,1713
320,1758518958585510313,1758518959862976672,1277.466,463,487,2124,1030,3154,39,39,2124,0.2292843691148776,1637
321,1758519555780457809,1758519558291678753,2511.221,463,487,2536,1018,3554,38,38,2536,0.1920347003154574,2049
322,1758520157989755026,1758520158370456548,380.702,463,487,2124,1030,3154,39,39,2124,0.2292843691148776,1637
323,1758520758206474852,1758520758343147102,136.672,463,487,2048,966,3014,37,37,2048,0.23779296875,1561
324,1758521358396256280,1758521358664903796,268.648,463,487,2124,1030,3154,39,39,2124,0.2292843691148776,1637
325,1758521959603952280,1758521960145291912,541.34,463,487,2124,1030,3154,39,39,2124,0.2292843691148776,1637
326,1758522555806329172,1758522556028724242,222.395,459,483,2272,1158,3430,43,43,2272,0.2125880281690141,1789
327,1758523156022908255,1758523156046874774,23.967,463,487,2200,1094,3294,41,41,2200,0.22136363636363637,1713
328,1758523757237913537,1758523757307826286,69.913,463,487,2048,966,3014,37,37,2048,0.23779296875,1561
329,1758524356445219882,1758524356519937889,74.718,459,483,2120,1030,3150,39,39,2120,0.2278301886792453,1637
330,1758524956646203205,1758524957798926613,1152.723,463,487,2688,1146,3834,42,42,2688,0.18117559523809523,2201
331,1758525557834370287,1758525559789289999,1954.92,463,487,2764,1158,3922,43,43,2764,0.17619392185238783,2277
332,1758526156043865427,1758526156331058591,287.193,463,487,2048,1018,3066,38,38,2048,0.23779296875,1561
333,1758526756257220788,1758526756296099992,38.879,463,487,2352,1222,3574,45,45,2352,0.2070578231292517,1865
334,1758527355447359748,1758527355459672112,12.312,463,487,1844,826,2670,32,32,1844,0.26409978308026033,1357
335,1758527957632959745,1758527959346145078,1713.185,459,483,2044,966,3010,37,37,2044,0.2363013698630137,1561
336,1758528557831103916,1758528557930026685,98.923,463,487,1972,902,2874,35,35,1972,0.24695740365111563,1485
337,1758529158046312753,1758529158335117501,288.805,463,487,2276,1158,3434,43,43,2276,0.2139718804920914,1789
338,1758529758259548405,1758529758360098306,100.55,463,487,2124,1030,3154,39,39,2124,0.2292843691148776,1637
339,1758530356442195057,1758530356695074080,252.879,463,487,2200,1094,3294,41,41,2200,0.22136363636363637,1713
340,1758530959650697755,1758530959928430774,277.733,463,487,1972,954,2926,36,36,1972,0.24695740365111563,1485
341,1758531557853194843,1758531557948059101,94.864,463,487,2428,1286,3714,47,47,2428,0.20057660626029655,1941
342,1758532156072223559,1758532156351666523,279.443,463,487,2124,1030,3154,39,39,2124,0.2292843691148776,1637
343,1758532786297903479,1758532786601366603,303.463,459,483,2196,1094,3290,41,41,2196,0.21994535519125682,1713
344,1758533355485025723,1758533355976408154,491.382,463,487,2200,1094,3294,41,41,2200,0.22136363636363637,1713
345,1758533957681483119,1758533957925038234,243.555,459,483,2120,1070,3190,40,40,2120,0.2278301886792453,1637
346,1758534555878573499,1758534555932415492,53.842,463,487,2124,1030,3154,39,39,2124,0.2292843691148776,1637
347,1758535156099801391,1758535156132964833,33.163,463,487,1896,838,2734,33,33,1896,0.2568565400843882,1409
348,1758535756313816833,1758535756547992779,234.176,467,491,2204,1198,3402,43,43,2204,0.22277676950998185,1713
349,1758536355509162673,1758536355524121699,14.959,459,483,1968,902,2870,35,35,1968,0.24542682926829268,1485
350,1758536955705037354,1758536955903783027,198.746,463,487,2048,966,3014,37,37,2048,0.23779296875,1561
351,1758537555890409287,1758537555903367969,12.959,459,483,2044,1018,3062,38,38,2044,0.2363013698630137,1561
352,1758538158109287712,1758538158122658505,13.371,463,487,1844,878,2722,33,33,1844,0.26409978308026033,1357
353,1758538757323702204,1758538757594289161,270.587,459,483,2120,1030,3150,39,39,2120,0.2278301886792453,1637
354,1758539356520051850,1758539356738474972,218.423,463,487,1896,838,2734,33,33,1896,0.2568565400843882,1409
355,1758539957710538482,1758539957927564470,217.026,463,487,2200,1094,3294,41,41,2200,0.22136363636363637,1713
356,1758540555892294816,1758540556034508848,142.214,459,483,1968,954,2922,36,36,1968,0.24542682926829268,1485
357,1758541156087254676,1758541156266407645,179.153,463,487,1972,902,2874,35,35,1972,0.24695740365111563,1485
358,1758541756301686756,1758541756386188686,84.502,463,487,2124,1030,3154,39,39,2124,0.2292843691148776,1637
359,1758542355507172649,1758542355751074501,243.902,459,483,2044,1018,3062,38,38,2044,0.2363013698630137,1561
360,1758542956699779438,1758542956901373744,201.594,463,487,1896,838,2734,33,33,1896,0.2568565400843882,1409
361,1758543555891338709,1758543556066503381,175.165,467,491,2204,1146,3350,42,42,2204,0.22277676950998185,1713
362,1758544156110384509,1758544156301385721,191.001,467,491,2128,1030,3158,39,39,2128,0.23073308270676693,1637
363,1758544756326063591,1758544756598346848,272.283,467,491,2052,966,3018,37,37,2052,0.23927875243664717,1561
364,1758545358535793660,1758545358729858646,194.065,467,491,1900,838,2738,33,33,1900,0.25842105263157894,1409
365,1758545955744070962,1758545955943656720,199.586,467,491,1900,838,2738,33,33,1900,0.25842105263157894,1409
366,1758546555953659224,1758546556126473534,172.814,467,491,2204,1146,3350,42,42,2204,0.22277676950998185,1713
367,1758547156173685580,1758547156429044322,255.359,467,491,1900,838,2738,33,33,1900,0.25842105263157894,1409
368,1758547756387842560,1758547756679693878,291.851,467,491,1900,838,2738,33,33,1900,0.25842105263157894,1409
369,1758548356593602831,1758548356645149556,51.547,467,491,1900,838,2738,33,33,1900,0.25842105263157894,1409
370,1758548955800169260,1758548955814007650,13.838,467,491,1900,838,2738,33,33,1900,0.25842105263157894,1409
371,1758549556005014390,1758549556278230555,273.216,467,491,1900,838,2738,33,33,1900,0.25842105263157894,1409
372,1758550156224697094,1758550156238685022,13.988,467,491,2000,954,2954,36,36,2000,0.2455,1509
373,1758550756439644267,1758550756637538748,197.894,467,491,1900,838,2738,33,33,1900,0.25842105263157894,1409
374,1758551356642445057,1758551356764832118,122.387,467,491,2052,966,3018,37,37,2052,0.23927875243664717,1561
375,1758551955837338424,1758551956085686385,248.348,467,491,1900,838,2738,33,33,1900,0.25842105263157894,1409
376,1758552556054894461,1758552556258915962,204.022,467,491,1900,838,2738,33,33,1900,0.25842105263157894,1409
377,1758553156272800808,1758553156530588452,257.788,463,487,1896,838,2734,33,33,1896,0.2568565400843882,1409
378,1758553756489629947,1758553756799488732,309.859,463,487,1896,838,2734,33,33,1896,0.2568565400843882,1409
379,1758554355700836794,1758554355827123115,126.286,467,491,1900,838,2738,33,33,1900,0.25842105263157894,1409
380,1758554955905811453,1758554956230598927,324.787,467,491,2128,1082,3210,40,40,2128,0.23073308270676693,1637
381,1758555558130321895,1758555558265575304,135.253,463,487,2124,1082,3206,40,40,2124,0.2292843691148776,1637
382,1758556157325132618,1758556157621987187,296.855,467,491,2128,1030,3158,39,39,2128,0.23073308270676693,1637
383,1758556755506218140,1758556755753036545,246.818,463,487,2200,1094,3294,41,41,2200,0.22136363636363637,1713
384,1758557355694418491,1758557355973154933,278.736,467,491,2204,1094,3298,41,41,2204,0.22277676950998185,1713
385,1758557957900453642,1758557957969867842,69.414,467,491,2128,1030,3158,39,39,2128,0.23073308270676693,1637
386,1758558559122640247,1758558561604999983,2482.36,463,487,2536,966,3502,37,37,2536,0.1920347003154574,2049
387,1758559156335860454,1758559156578081082,242.221,467,491,2128,1030,3158,39,39,2128,0.23073308270676693,1637
388,1758559756537573174,1758559756710208831,172.636,463,487,2048,966,3014,37,37,2048,0.23779296875,1561
389,1758560357732072530,1758560357748029429,15.957,467,491,2204,1094,3298,41,41,2204,0.22277676950998185,1713
390,1758560955944387430,1758560955956096434,11.709,467,491,1848,826,2674,32,32,1848,0.2656926406926407,1357
391,1758561556165601149,1758561556428387983,262.787,463,487,1844,838,2682,32,32,1844,0.26409978308026033,1357
392,1758562156381043090,1758562156547349948,166.307,467,491,620,78,698,3,3,620,0.7919354838709678,129
